აალებადი	ɑɑlɛbɑdi	ɑɑlɛbɑdɪ
აალებული	ɑɑlɛbuli	ɑɑlɛbulɪ
აბაზი	ɑbɑzi	ɑbɑzɪ
აბაკი	ɑbɑkʼi	ɑbɑkʼɪ
აბანოზი	ɑbɑnɔzi	ɑbɑnɔzɪ
აბეზღებს	ɑbɛzɣɛbs	ɑbɛzʁɛbs
აბიბინებს	ɑbibinɛbs	ɑbɪbɪnɛbs
აბინძურებს	ɑbindzurɛbs	ɑbɪndzurɛbs
აბრეშუმი	ɑbrɛʃumi	ɑbrɛʃumɪ
აბსოლუტიზმი	ɑbsɔlutʼizmi	ɑbsɔlutʼɪzmɪ
აბსურდული	ɑbsurduli	ɑbsurdulɪ
აბუსერიძე	ɑbusɛridzɛ	ɑbusɛrɪdzɛ
აბშილავა	ɑbʃilɑvɑ	ɑbʃɪlɑvɑ
აბჯარი	ɑbdʒɑri	ɑbdʒɑrɪ
აგებინებს	ɑɡɛbinɛbs	ɑɡɛbɪnɛbs
აგვირგვინებს	ɑɡvirɡvinɛbs	ɑɡvɪrɡvɪnɛbs
აგვისტო	ɑɡvistʼɔ	ɑɡvɪstʼɔ
აგიდელი	ɑɡidɛli	ɑɡɪdɛlɪ
აგინებს	ɑɡinɛbs	ɑɡɪnɛbs
აგნოსტიკური	ɑɡnɔstʼikʼuri	ɑɡnɔstʼɪkʼurɪ
აგრესიულად	ɑɡrɛsiulɑd	ɑɡrɛsɪulɑd
აგრესიული	ɑɡrɛsiuli	ɑɡrɛsɪulɪ
აგრესიულობა	ɑɡrɛsiulɔbɑ	ɑɡrɛsɪulɔbɑ
აგური	ɑɡuri	ɑɡurɪ
ადათი	ɑdɑtʰi	ɑdɑtʰɪ
ადამიანი	ɑdɑmiɑni	ɑdɑmɪɑnɪ
ადაპტაცია	ɑdɑpʼtʼɑtsiɑ	ɑdɑpʼtʼɑtsɪɑ
ადგილი	ɑdɡili	ɑdɡɪlɪ
ადგილობრივი	ɑdɡilɔbrivi	ɑdɡɪlɔbrɪvɪ
ადეკვატური	ɑdɛkʼvɑtʼuri	ɑdɛkʼvɑtʼurɪ
ადვილი	ɑdvili	ɑdvɪlɪ
ადიდებს	ɑdidɛbs	ɑdɪdɛbs
ადის	ɑdis	ɑdɪs
ადუღება	ɑduɣɛbɑ	ɑduʁɛbɑ
ადუღებს	ɑduɣɛbs	ɑduʁɛbs
აეროპორტი	ɑɛrɔpʼɔrtʼi	ɑɛrɔpʼɔrtʼɪ
ავადმყოფი	ɑvɑdmqʼɔpʰi	ɑvɑdmqʼɔpʰɪ
ავარია	ɑvɑriɑ	ɑvɑrɪɑ
ავბედითი	ɑvbɛditʰi	ɑvbɛdɪtʰɪ
ავდარი	ɑvdɑri	ɑvdɑrɪ
ავი	ɑvi	ɑvɪ
ავიაკომპანია	ɑviɑkʼɔmpʼɑniɑ	ɑvɪɑkʼɔmpʼɑnɪɑ
ავიაქარხანა	ɑviɑkʰɑrxɑnɑ	ɑvɪɑkʰɑrχɑnɑ
ავიწროვებს	ɑvitsʼrɔvɛbs	ɑvɪtsʼrɔvɛbs
ავლაბარი	ɑvlɑbɑri	ɑvlɑbɑrɪ
ავსტრალია	ɑvstʼrɑliɑ	ɑvstʼrɑlɪɑ
ავსტრია	ɑvstʼriɑ	ɑvstʼrɪɑ
ავტომატი	ɑvtʼɔmɑtʼi	ɑvtʼɔmɑtʼɪ
ავტორები	ɑvtʼɔrɛbi	ɑvtʼɔrɛbɪ
ავტორი	ɑvtʼɔri	ɑvtʼɔrɪ
ავტოსადგომი	ɑvtʼɔsɑdɡɔmi	ɑvtʼɔsɑdɡɔmɪ
ავღანეთი	ɑvɣɑnɛtʰi	ɑvʁɑnɛtʰɪ
ავღანელი	ɑvɣɑnɛli	ɑvʁɑnɛlɪ
ავღანური	ɑvɣɑnuri	ɑvʁɑnurɪ
ავხორცად	ɑvxɔrtsɑd	ɑvχɔrtsɑd
ავხორცი	ɑvxɔrtsi	ɑvχɔrtsɪ
ავხორცობა	ɑvxɔrtsɔbɑ	ɑvχɔrtsɔbɑ
აზარტული	ɑzɑrtʼuli	ɑzɑrtʼulɪ
აზერბაიჯანი	ɑzɛrbɑidʒɑni	ɑzɛrbɑɪdʒɑnɪ
აზვიადებს	ɑzviɑdɛbs	ɑzvɪɑdɛbs
აზნაური	ɑznɑuri	ɑznɑurɪ
აზოტი	ɑzɔtʼi	ɑzɔtʼɪ
აზრი	ɑzri	ɑzrɪ
აზრიანი	ɑzriɑni	ɑzrɪɑnɪ
აზღუდი	ɑzɣudi	ɑzʁudɪ
ათავისუფლებს	ɑtʰɑvisupʰlɛbs	ɑtʰɑvɪsupʰlɛbs
ათარიღებს	ɑtʰɑriɣɛbs	ɑtʰɑrɪʁɛbs
ათასი	ɑtʰɑsi	ɑtʰɑsɪ
ათაშანგი	ɑtʰɑʃɑnɡi	ɑtʰɑʃɑnɡɪ
ათესვინებს	ɑtʰɛsvinɛbs	ɑtʰɛsvɪnɛbs
ათვალიერებს	ɑtʰvɑliɛrɛbs	ɑtʰvɑlɪɛrɛbs
ათი	ɑtʰi	ɑtʰɪ
ათლეტური	ɑtʰlɛtʼuri	ɑtʰlɛtʼurɪ
ათქვეფილი	ɑtʰkʰvɛpʰili	ɑtʰkʰvɛpʰɪlɪ
ათხოვებს	ɑtʰxɔvɛbs	ɑtʰχɔvɛbs
აიაფებს	ɑiɑpʰɛbs	ɑɪɑpʰɛbs
აინტერესებს	ɑintʼɛrɛsɛbs	ɑɪntʼɛrɛsɛbs
აინშტაინიუმი	ɑinʃtʼɑiniumi	ɑɪnʃtʼɑɪnɪumɪ
აკაკი	ɑkʼɑkʼi	ɑkʼɑkʼɪ
აკვანნი	ɑkʼvɑnni	ɑkʼvɑnnɪ
აკვიატება	ɑkʼviɑtʼɛbɑ	ɑkʼvɪɑtʼɛbɑ
აკვირვებს	ɑkʼvirvɛbs	ɑkʼvɪrvɛbs
აკვნები	ɑkʼvnɛbi	ɑkʼvnɛbɪ
აკვნებით	ɑkʼvnɛbitʰ	ɑkʼvnɛbɪtʰ
აკვნების	ɑkʼvnɛbis	ɑkʼvnɛbɪs
აკვნით	ɑkʼvnitʰ	ɑkʼvnɪtʰ
აკვნის	ɑkʼvnis	ɑkʼvnɪs
აკვრევინებს	ɑkʼvrɛvinɛbs	ɑkʼvrɛvɪnɛbs
აკლია	ɑkʼliɑ	ɑkʼlɪɑ
აკრისტალებს	ɑkʼristʼɑlɛbs	ɑkʼrɪstʼɑlɛbs
აკრძალული	ɑkʼrdzɑluli	ɑkʼrdzɑlulɪ
აკურატული	ɑkʼurɑtʼuli	ɑkʼurɑtʼulɪ
ალავერდი	ɑlɑvɛrdi	ɑlɑvɛrdɪ
ალაზანი	ɑlɑzɑni	ɑlɑzɑnɪ
ალალი	ɑlɑli	ɑlɑlɪ
ალამი	ɑlɑmi	ɑlɑmɪ
ალასანია	ɑlɑsɑniɑ	ɑlɑsɑnɪɑ
ალბანეთი	ɑlbɑnɛtʰi	ɑlbɑnɛtʰɪ
ალგორითმი	ɑlɡɔritʰmi	ɑlɡɔrɪtʰmɪ
ალდატი	ɑldɑtʼi	ɑldɑtʼɪ
ალერსი	ɑlɛrsi	ɑlɛrsɪ
ალერსიანი	ɑlɛrsiɑni	ɑlɛrsɪɑnɪ
ალიზი	ɑlizi	ɑlɪzɪ
ალიონი	ɑliɔni	ɑlɪɔnɪ
ალიტერაციული	ɑlitʼɛrɑtsiuli	ɑlɪtʼɛrɑtsɪulɪ
ალკოჰოლი	ɑlkʼɔhɔli	ɑlkʼɔhɔlɪ
ალკოჰოლიანი	ɑlkʼɔhɔliɑni	ɑlkʼɔhɔlɪɑnɪ
ალმანახი	ɑlmɑnɑxi	ɑlmɑnɑχɪ
ალჟირი	ɑlʒiri	ɑlʒɪrɪ
ალუბალი	ɑlubɑli	ɑlubɑlɪ
ალუვიური	ɑluviuri	ɑluvɪurɪ
ალუმინი	ɑlumini	ɑlumɪnɪ
ამანათი	ɑmɑnɑtʰi	ɑmɑnɑtʰɪ
ამაღელვებელი	ɑmɑɣɛlvɛbɛli	ɑmɑʁɛlvɛbɛlɪ
ამაღლებულად	ɑmɑɣlɛbulɑd	ɑmɑʁlɛbulɑd
ამაღლებული	ɑmɑɣlɛbuli	ɑmɑʁlɛbulɪ
ამაღლებულობა	ɑmɑɣlɛbulɔbɑ	ɑmɑʁlɛbulɔbɑ
ამაყი	ɑmɑqʼi	ɑmɑqʼɪ
ამახინჯებს	ɑmɑxindʒɛbs	ɑmɑχɪndʒɛbs
ამბავი	ɑmbɑvi	ɑmbɑvɪ
ამბოხი	ɑmbɔxi	ɑmbɔχɪ
ამერიკა	ɑmɛrikʼɑ	ɑmɛrɪkʼɑ
ამინდი	ɑmindi	ɑmɪndɪ
ამირანი	ɑmirɑni	ɑmɪrɑnɪ
ამირი	ɑmiri	ɑmɪrɪ
ამოზნექილად	ɑmɔznɛkʰilɑd	ɑmɔznɛkʰɪlɑd
ამოზნექილი	ɑmɔznɛkʰili	ɑmɔznɛkʰɪlɪ
ამოზნექილობა	ɑmɔznɛkʰilɔbɑ	ɑmɔznɛkʰɪlɔbɑ
ამორძალი	ɑmɔrdzɑli	ɑmɔrdzɑlɪ
ამოძირკვავს	ɑmɔdzirkʼvɑvs	ɑmɔdzɪrkʼvɑvs
ამპარტავანი	ɑmpʼɑrtʼɑvɑni	ɑmpʼɑrtʼɑvɑnɪ
ამრეკლავი	ɑmrɛkʼlɑvi	ɑmrɛkʼlɑvɪ
ამსტერდამი	ɑmstʼɛrdɑmi	ɑmstʼɛrdɑmɪ
ამტანი	ɑmtʼɑni	ɑmtʼɑnɪ
ამუხრუჭებს	ɑmuxrutʃʼɛbs	ɑmuχrutʃʼɛbs
ამღერებს	ɑmɣɛrɛbs	ɑmʁɛrɛbs
ამღვრეულობა	ɑmɣvrɛulɔbɑ	ɑmʁvrɛulɔbɑ
ამშვიდებს	ɑmʃvidɛbs	ɑmʃvɪdɛbs
ამძვრალი	ɑmdzvrɑli	ɑmdzvrɑlɪ
ამძიმებს	ɑmdzimɛbs	ɑmdzɪmɛbs
ამწიფებს	ɑmtsʼipʰɛbs	ɑmtsʼɪpʰɛbs
ამწნილებს	ɑmtsʼnilɛbs	ɑmtsʼnɪlɛbs
ამხანაგი	ɑmxɑnɑɡi	ɑmχɑnɑɡɪ
ამხანაგობა	ɑmxɑnɑɡɔbɑ	ɑmχɑnɑɡɔbɑ
ამჯობინებს	ɑmdʒɔbinɛbs	ɑmdʒɔbɪnɛbs
ანაბარი	ɑnɑbɑri	ɑnɑbɑrɪ
ანაგვიანებს	ɑnɑɡviɑnɛbs	ɑnɑɡvɪɑnɛbs
ანალოგიური	ɑnɑlɔɡiuri	ɑnɑlɔɡɪurɪ
ანაფილაქსია	ɑnɑpʰilɑkʰsiɑ	ɑnɑpʰɪlɑkʰsɪɑ
ანაღდებს	ɑnɑɣdɛbs	ɑnɑʁdɛbs
ანახვებს	ɑnɑxvɛbs	ɑnɑχvɛbs
ანახშირებს	ɑnɑxʃirɛbs	ɑnɑχʃɪrɛbs
ანბანი	ɑnbɑni	ɑnbɑnɪ
ანგარებიანი	ɑnɡɑrɛbiɑni	ɑnɡɑrɛbɪɑnɪ
ანგარი	ɑnɡɑri	ɑnɡɑrɪ
ანგარიშვალდებულება	ɑnɡɑriʃvɑldɛbulɛbɑ	ɑnɡɑrɪʃvɑldɛbulɛbɑ
ანგარიშვალდებული	ɑnɡɑriʃvɑldɛbuli	ɑnɡɑrɪʃvɑldɛbulɪ
ანგარიში	ɑnɡɑriʃi	ɑnɡɑrɪʃɪ
ანგარიშიანი	ɑnɡɑriʃiɑni	ɑnɡɑrɪʃɪɑnɪ
ანგია	ɑnɡiɑ	ɑnɡɪɑ
ანგლიკანური	ɑnɡlikʼɑnuri	ɑnɡlɪkʼɑnurɪ
ანდამატი	ɑndɑmɑtʼi	ɑndɑmɑtʼɪ
ანისი	ɑnisi	ɑnɪsɪ
ანონიმური	ɑnɔnimuri	ɑnɔnɪmurɪ
ანონიმურობა	ɑnɔnimurɔbɑ	ɑnɔnɪmurɔbɑ
ანტიკური	ɑntʼikʼuri	ɑntʼɪkʼurɪ
ანტიკურობა	ɑntʼikʼurɔbɑ	ɑntʼɪkʼurɔbɑ
ანტონი	ɑntʼɔni	ɑntʼɔnɪ
აოთხმაგებს	ɑɔtʰxmɑɡɛbs	ɑɔtʰχmɑɡɛbs
აპირებს	ɑpʼirɛbs	ɑpʼɪrɛbs
აპლიკაცია	ɑpʼlikʼɑtsiɑ	ɑpʼlɪkʼɑtsɪɑ
აპნისი	ɑpʼnisi	ɑpʼnɪsɪ
აპრილი	ɑpʼrili	ɑpʼrɪlɪ
არაბი	ɑrɑbi	ɑrɑbɪ
არაბიძე	ɑrɑbidzɛ	ɑrɑbɪdzɛ
არაბული	ɑrɑbuli	ɑrɑbulɪ
არადიპლომატიურად	ɑrɑdipʼlɔmɑtʼiurɑd	ɑrɑdɪpʼlɔmɑtʼɪurɑd
არაეფექტური	ɑrɑɛpʰɛkʰtʼuri	ɑrɑɛpʰɛkʰtʼurɪ
არავითარი	ɑrɑvitʰɑri	ɑrɑvɪtʰɑrɪ
არაზუსტი	ɑrɑzustʼi	ɑrɑzustʼɪ
არათანაბარი	ɑrɑtʰɑnɑbɑri	ɑrɑtʰɑnɑbɑrɪ
არათითი	ɑrɑtʰitʰi	ɑrɑtʰɪtʰɪ
არაკორექტული	ɑrɑkʼɔrɛkʰtʼuli	ɑrɑkʼɔrɛkʰtʼulɪ
არამუსიკალურად	ɑrɑmusikʼɑlurɑd	ɑrɑmusɪkʼɑlurɑd
არანაირი	ɑrɑnɑiri	ɑrɑnɑɪrɪ
არაოფიციალური	ɑrɑɔpʰitsiɑluri	ɑrɑɔpʰɪtsɪɑlurɪ
არაპროდუქტიულად	ɑrɑpʼrɔdukʰtʼiulɑd	ɑrɑpʼrɔdukʰtʼɪulɑd
არარატი	ɑrɑrɑtʼi	ɑrɑrɑtʼɪ
არასასურველი	ɑrɑsɑsurvɛli	ɑrɑsɑsurvɛlɪ
არაფერი	ɑrɑpʰɛri	ɑrɑpʰɛrɪ
არაფრის	ɑrɑpʰris	ɑrɑpʰrɪs
არაქათი	ɑrɑkʰɑtʰi	ɑrɑkʰɑtʰɪ
არაქისი	ɑrɑkʰisi	ɑrɑkʰɪsɪ
არაყი	ɑrɑqʼi	ɑrɑqʼɪ
არაჯანსაღი	ɑrɑdʒɑnsɑɣi	ɑrɑdʒɑnsɑʁɪ
არბილებს	ɑrbilɛbs	ɑrbɪlɛbs
არგენტინა	ɑrɡɛntʼinɑ	ɑrɡɛntʼɪnɑ
არგონავტი	ɑrɡɔnɑvtʼi	ɑrɡɔnɑvtʼɪ
არგონი	ɑrɡɔni	ɑrɡɔnɪ
არდადეგები	ɑrdɑdɛɡɛbi	ɑrdɑdɛɡɛbɪ
არდი	ɑrdi	ɑrdɪ
არეგულირებს	ɑrɛɡulirɛbs	ɑrɛɡulɪrɛbs
არეული	ɑrɛuli	ɑrɛulɪ
არის	ɑris	ɑrɪs
არისტოტელე	ɑristʼɔtʼɛlɛ	ɑrɪstʼɔtʼɛlɛ
არიფი	ɑripʰi	ɑrɪpʰɪ
არომატი	ɑrɔmɑtʼi	ɑrɔmɑtʼɪ
არომატული	ɑrɔmɑtʼuli	ɑrɔmɑtʼulɪ
არსებითი	ɑrsɛbitʰi	ɑrsɛbɪtʰɪ
არსი	ɑrsi	ɑrsɪ
არსით	ɑrsitʰ	ɑrsɪtʰ
არქიტექტორი	ɑrkʰitʼɛkʰtʼɔri	ɑrkʰɪtʼɛkʰtʼɔrɪ
არღანი	ɑrɣɑni	ɑrʁɑnɪ
არშიყობა	ɑrʃiqʼɔbɑ	ɑrʃɪqʼɔbɑ
არჩევნები	ɑrtʃɛvnɛbi	ɑrtʃɛvnɛbɪ
არჩვი	ɑrtʃvi	ɑrtʃvɪ
არცერთი	ɑrtsɛrtʰi	ɑrtsɛrtʰɪ
არწივი	ɑrtsʼivi	ɑrtsʼɪvɪ
არხეინი	ɑrxɛini	ɑrχɛɪnɪ
ასახავს	ɑsɑxɑvs	ɑsɑχɑvs
ასახელებს	ɑsɑxɛlɛbs	ɑsɑχɛlɛbs
ასახიჩრებს	ɑsɑxitʃrɛbs	ɑsɑχɪtʃrɛbs
ასექსუალი	ɑsɛkʰsuɑli	ɑsɛkʰsuɑlɪ
ასი	ɑsi	ɑsɪ
ასლოკინებს	ɑslɔkʼinɛbs	ɑslɔkʼɪnɛbs
ასომთავრული	ɑsɔmtʰɑvruli	ɑsɔmtʰɑvrulɪ
ასტატი	ɑstʼɑtʼi	ɑstʼɑtʼɪ
ასტროლოგია	ɑstʼrɔlɔɡiɑ	ɑstʼrɔlɔɡɪɑ
ასტრონომია	ɑstʼrɔnɔmiɑ	ɑstʼrɔnɔmɪɑ
ასული	ɑsuli	ɑsulɪ
ასურეთი	ɑsurɛtʰi	ɑsurɛtʰɪ
ასწავლის	ɑstsʼɑvlis	ɑstsʼɑvlɪs
ატამი	ɑtʼɑmi	ɑtʼɑmɪ
ატენიანებს	ɑtʼɛniɑnɛbs	ɑtʼɛnɪɑnɛbs
აუგი	ɑuɡi	ɑuɡɪ
აუცილებლად	ɑutsilɛblɑd	ɑutsɪlɛblɑd
აფალინა	ɑpʰɑlinɑ	ɑpʰɑlɪnɑ
აფერისტი	ɑpʰɛristʼi	ɑpʰɛrɪstʼɪ
აფთარი	ɑpʰtʰɑri	ɑpʰtʰɑrɪ
აფთიაქი	ɑpʰtʰiɑkʰi	ɑpʰtʰɪɑkʰɪ
აფიცებს	ɑpʰitsɛbs	ɑpʰɪtsɛbs
აფხაზეთი	ɑpʰxɑzɛtʰi	ɑpʰχɑzɛtʰɪ
აფხაზი	ɑpʰxɑzi	ɑpʰχɑzɪ
აფხაზური	ɑpʰxɑzuri	ɑpʰχɑzurɪ
აქანდაზი	ɑkʰɑndɑzi	ɑkʰɑndɑzɪ
აქლემი	ɑkʰlɛmi	ɑkʰlɛmɪ
აქროლადი	ɑkʰrɔlɑdi	ɑkʰrɔlɑdɪ
აქტინიუმი	ɑkʰtʼiniumi	ɑkʰtʼɪnɪumɪ
აქტიურად	ɑkʰtʼiurɑd	ɑkʰtʼɪurɑd
აქტიური	ɑkʰtʼiuri	ɑkʰtʼɪurɪ
აქცია	ɑkʰtsiɑ	ɑkʰtsɪɑ
აღვიძებს	ɑɣvidzɛbs	ɑʁvɪdzɛbs
აღთქმა	ɑɣtʰkʰmɑ	ɑʁtʰkʰmɑ
აღკაზმულობა	ɑɣkʼɑzmulɔbɑ	ɑʁkʼɑzmulɔbɑ
აღმატებითი	ɑɣmɑtʼɛbitʰi	ɑʁmɑtʼɛbɪtʰɪ
აღმატებული	ɑɣmɑtʼɛbuli	ɑʁmɑtʼɛbulɪ
აღმაშენებელი	ɑɣmɑʃɛnɛbɛli	ɑʁmɑʃɛnɛbɛlɪ
აღმოაჩინე	ɑɣmɔɑtʃinɛ	ɑʁmɔɑtʃɪnɛ
აღმოაჩინო	ɑɣmɔɑtʃinɔ	ɑʁmɔɑtʃɪnɔ
აღმოსავლეთი	ɑɣmɔsɑvlɛtʰi	ɑʁmɔsɑvlɛtʰɪ
აღნაგობა	ɑɣnɑɡɔbɑ	ɑʁnɑɡɔbɑ
აღნიშნავს	ɑɣniʃnɑvs	ɑʁnɪʃnɑvs
აღნიშნული	ɑɣniʃnuli	ɑʁnɪʃnulɪ
აღსარება	ɑɣsɑrɛbɑ	ɑʁsɑrɛbɑ
აღძრავს	ɑɣdzrɑvs	ɑʁdzrɑvs
აღჭურვილობა	ɑɣtʃʼurvilɔbɑ	ɑʁtʃʼurvɪlɔbɑ
აყვავებული	ɑqʼvɑvɛbuli	ɑqʼvɑvɛbulɪ
აშიკი	ɑʃikʼi	ɑʃɪkʼɪ
აშინებს	ɑʃinɛbs	ɑʃɪnɛbs
აშლილი	ɑʃlili	ɑʃlɪlɪ
აშლილობა	ɑʃlilɔbɑ	ɑʃlɪlɔbɑ
აშლის	ɑʃlis	ɑʃlɪs
აცოცხლებს	ɑtsɔtsxlɛbs	ɑtsɔtsχlɛbs
აცხადებს	ɑtsxɑdɛbs	ɑtsχɑdɛbs
აცხობს	ɑtsxɔbs	ɑtsχɔbs
აწეწილი	ɑtsʼɛtsʼili	ɑtsʼɛtsʼɪlɪ
აწვრილებს	ɑtsʼvrilɛbs	ɑtsʼvrɪlɛbs
აწითლებს	ɑtsʼitʰlɛbs	ɑtsʼɪtʰlɛbs
აწყვეტინებს	ɑtsʼqʼvɛtʼinɛbs	ɑtsʼqʼvɛtʼɪnɛbs
ახალგაზრდა	ɑxɑlɡɑzrdɑ	ɑχɑlɡɑzrdɑ
ახალგაზრდობა	ɑxɑlɡɑzrdɔbɑ	ɑχɑlɡɑzrdɔbɑ
ახალგაზრდულად	ɑxɑlɡɑzrdulɑd	ɑχɑlɡɑzrdulɑd
ახალი	ɑxɑli	ɑχɑlɪ
ახარისხებს	ɑxɑrisxɛbs	ɑχɑrɪsχɛbs
ახდის	ɑxdis	ɑχdɪs
ახვრობა	ɑxvrɔbɑ	ɑχvrɔbɑ
ახირებული	ɑxirɛbuli	ɑχɪrɛbulɪ
ახირებულობა	ɑxirɛbulɔbɑ	ɑχɪrɛbulɔbɑ
ახლა	ɑxlɑ	ɑχlɑ
ახმაურებს	ɑxmɑurɛbs	ɑχmɑurɛbs
ახორციელებს	ɑxɔrtsiɛlɛbs	ɑχɔrtsɪɛlɛbs
ახსოვს	ɑxsɔvs	ɑχsɔvs
ახურებს	ɑxurɛbs	ɑχurɛbs
აჯასპი	ɑdʒɑspʼi	ɑdʒɑspʼɪ
აჯაფსანდალი	ɑdʒɑpʰsɑndɑli	ɑdʒɑpʰsɑndɑlɪ
აჯიკა	ɑdʒikʼɑ	ɑdʒɪkʼɑ
აჯილდოებს	ɑdʒildɔɛbs	ɑdʒɪldɔɛbs
ბაგრატიონი	bɑɡrɑtʼiɔni	bɑɡrɑtʼɪɔnɪ
ბადაგი	bɑdɑɡi	bɑdɑɡɪ
ბადალი	bɑdɑli	bɑdɑlɪ
ბადრიჯანი	bɑdridʒɑni	bɑdrɪdʒɑnɪ
ბავშვები	bɑvʃvɛbi	bɑvʃvɛbɪ
ბავშვი	bɑvʃvi	bɑvʃvɪ
ბაზარი	bɑzɑri	bɑzɑrɪ
ბაზელი	bɑzɛli	bɑzɛlɪ
ბათუმი	bɑtʰumi	bɑtʰumɪ
ბათქაში	bɑtʰkʰɑʃi	bɑtʰkʰɑʃɪ
ბაიაშვილი	bɑiɑʃvili	bɑɪɑʃvɪlɪ
ბაითი	bɑitʰi	bɑɪtʰɪ
ბაირაღი	bɑirɑɣi	bɑɪrɑʁɪ
ბალახი	bɑlɑxi	bɑlɑχɪ
ბალი	bɑli	bɑlɪ
ბალკონი	bɑlkʼɔni	bɑlkʼɔnɪ
ბანალური	bɑnɑluri	bɑnɑlurɪ
ბანგლადეში	bɑnɡlɑdɛʃi	bɑnɡlɑdɛʃɪ
ბანი	bɑni	bɑnɪ
ბანძი	bɑndzi	bɑndzɪ
ბარათი	bɑrɑtʰi	bɑrɑtʰɪ
ბარბადოსი	bɑrbɑdɔsi	bɑrbɑdɔsɪ
ბარბარიზმი	bɑrbɑrizmi	bɑrbɑrɪzmɪ
ბარბაროსი	bɑrbɑrɔsi	bɑrbɑrɔsɪ
ბარდი	bɑrdi	bɑrdɪ
ბარი	bɑri	bɑrɪ
ბარტყი	bɑrtʼqʼi	bɑrtʼqʼɪ
ბარჯი	bɑrdʒi	bɑrdʒɪ
ბასრი	bɑsri	bɑsrɪ
ბასტიონი	bɑstʼiɔni	bɑstʼɪɔnɪ
ბატი	bɑtʼi	bɑtʼɪ
ბატონი	bɑtʼɔni	bɑtʼɔnɪ
ბაღი	bɑɣi	bɑʁɪ
ბაღლინჯო	bɑɣlindʒɔ	bɑʁlɪndʒɔ
ბაღჩა	bɑɣtʃɑ	bɑʁtʃɑ
ბაყაყი	bɑqʼɑqʼi	bɑqʼɑqʼɪ
ბაწარი	bɑtsʼɑri	bɑtsʼɑrɪ
ბაჰრეინი	bɑhrɛini	bɑhrɛɪnɪ
ბებერი	bɛbɛri	bɛbɛrɪ
ბებია	bɛbiɑ	bɛbɪɑ
ბედი	bɛdi	bɛdɪ
ბევრი	bɛvri	bɛvrɪ
ბელარუსი	bɛlɑrusi	bɛlɑrusɪ
ბელგია	bɛlɡiɑ	bɛlɡɪɑ
ბელიზი	bɛlizi	bɛlɪzɪ
ბენინი	bɛnini	bɛnɪnɪ
ბერი	bɛri	bɛrɪ
ბერილიუმი	bɛriliumi	bɛrɪlɪumɪ
ბერლინი	bɛrlini	bɛrlɪnɪ
ბეროშვილი	bɛrɔʃvili	bɛrɔʃvɪlɪ
ბერუაშვილი	bɛruɑʃvili	bɛruɑʃvɪlɪ
ბერძენი	bɛrdzɛni	bɛrdzɛnɪ
ბერძნული	bɛrdznuli	bɛrdznulɪ
ბესარიონი	bɛsɑriɔni	bɛsɑrɪɔnɪ
ბეწვი	bɛtsʼvi	bɛtsʼvɪ
ბეჭედი	bɛtʃʼɛdi	bɛtʃʼɛdɪ
ბეჯითად	bɛdʒitʰɑd	bɛdʒɪtʰɑd
ბეჯითი	bɛdʒitʰi	bɛdʒɪtʰɪ
ბზარი	bzɑri	bzɑrɪ
ბზიკი	bzikʼi	bzɪkʼɪ
ბიბლია	bibliɑ	bɪblɪɑ
ბიბლიოთეკა	bibliɔtʰɛkʼɑ	bɪblɪɔtʰɛkʼɑ
ბილეთი	bilɛtʰi	bɪlɛtʰɪ
ბილიარდი	biliɑrdi	bɪlɪɑrdɪ
ბილიკი	bilikʼi	bɪlɪkʼɪ
ბინძურად	bindzurɑd	bɪndzurɑd
ბინძური	bindzuri	bɪndzurɪ
ბიოგრაფიული	biɔɡrɑpʰiuli	bɪɔɡrɑpʰɪulɪ
ბიოლოგიური	biɔlɔɡiuri	bɪɔlɔɡɪurɪ
ბირთვი	birtʰvi	bɪrtʰvɪ
ბირკა	birkʼɑ	bɪrkʼɑ
ბირჟა	birʒɑ	bɪrʒɑ
ბისექსუალი	bisɛkʰsuɑli	bɪsɛkʰsuɑlɪ
ბისექსუალობა	bisɛkʰsuɑlɔbɑ	bɪsɛkʰsuɑlɔbɑ
ბისმუტი	bismutʼi	bɪsmutʼɪ
ბიუჯეტიანი	biudʒɛtʼiɑni	bɪudʒɛtʼɪɑnɪ
ბიძა	bidzɑ	bɪdzɑ
ბიძგი	bidzɡi	bɪdzɡɪ
ბიჭვინთა	bitʃʼvintʰɑ	bɪtʃʼvɪntʰɑ
ბიჭი	bitʃʼi	bɪtʃʼɪ
ბიჭუნა	bitʃʼunɑ	bɪtʃʼunɑ
ბიჭუნები	bitʃʼunɛbi	bɪtʃʼunɛbɪ
ბლაგვი	blɑɡvi	blɑɡvɪ
ბლოგი	blɔɡi	blɔɡɪ
ბმული	bmuli	bmulɪ
ბნელი	bnɛli	bnɛlɪ
ბოდიში	bɔdiʃi	bɔdɪʃɪ
ბოზი	bɔzi	bɔzɪ
ბოთლი	bɔtʰli	bɔtʰlɪ
ბოლი	bɔli	bɔlɪ
ბოლიანი	bɔliɑni	bɔlɪɑnɪ
ბოლივია	bɔliviɑ	bɔlɪvɪɑ
ბოლოკი	bɔlɔkʼi	bɔlɔkʼɪ
ბომბი	bɔmbi	bɔmbɪ
ბონბონიერი	bɔnbɔniɛri	bɔnbɔnɪɛrɪ
ბორანი	bɔrɑni	bɔrɑnɪ
ბორბალი	bɔrbɑli	bɔrbɑlɪ
ბორი	bɔri	bɔrɪ
ბოროტი	bɔrɔtʼi	bɔrɔtʼɪ
ბორცვი	bɔrtsvi	bɔrtsvɪ
ბორჯომი	bɔrdʒɔmi	bɔrdʒɔmɪ
ბოღმა	bɔɣmɑ	bɔʁmɑ
ბოცვერი	bɔtsvɛri	bɔtsvɛrɪ
ბრაზი	brɑzi	brɑzɪ
ბრაზილია	brɑziliɑ	brɑzɪlɪɑ
ბრალეული	brɑlɛuli	brɑlɛulɪ
ბრალი	brɑli	brɑlɪ
ბრატცი	brɑtʼtsi	brɑtʼtsɪ
ბრდღვნის	brdɣvnis	brdʁvnɪs
ბრინჯაო	brindʒɑɔ	brɪndʒɑɔ
ბრინჯი	brindʒi	brɪndʒɪ
ბრიყვი	briqʼvi	brɪqʼvɪ
ბროლი	brɔli	brɔlɪ
ბროში	brɔʃi	brɔʃɪ
ბრტყელი	brtʼqʼɛli	brtʼqʼɛlɪ
ბრუნეი	brunɛi	brunɛɪ
ბრძანებითი	brdzɑnɛbitʰi	brdzɑnɛbɪtʰɪ
ბრძენი	brdzɛni	brdzɛnɪ
ბრწყინავს	brtsʼqʼinɑvs	brtsʼqʼɪnɑvs
ბუზი	buzi	buzɪ
ბუკი	bukʼi	bukʼɪ
ბუკმეკერი	bukʼmɛkʼɛri	bukʼmɛkʼɛrɪ
ბულბული	bulbuli	bulbulɪ
ბულგარეთი	bulɡɑrɛtʰi	bulɡɑrɛtʰɪ
ბულგარული	bulɡɑruli	bulɡɑrulɪ
ბუნებრივი	bunɛbrivi	bunɛbrɪvɪ
ბუნიობა	buniɔbɑ	bunɪɔbɑ
ბუნტი	buntʼi	buntʼɪ
ბურთი	burtʰi	burtʰɪ
ბურნუთი	burnutʰi	burnutʰɪ
ბურჟუაზიული	burʒuɑziuli	burʒuɑzɪulɪ
ბურუნდი	burundi	burundɪ
ბურღავს	burɣɑvs	burʁɑvs
ბურჯი	burdʒi	burdʒɪ
ბუსუსი	bususi	bususɪ
ბუფეტი	bupʰɛtʼi	bupʰɛtʼɪ
ბუქარესტი	bukʰɑrɛstʼi	bukʰɑrɛstʼɪ
ბუქსირება	bukʰsirɛbɑ	bukʰsɪrɛbɑ
ბუქსირები	bukʰsirɛbi	bukʰsɪrɛbɪ
ბუქსირი	bukʰsiri	bukʰsɪrɪ
ბუღალტერია	buɣɑltʼɛriɑ	buʁɑltʼɛrɪɑ
ბუშტი	buʃtʼi	buʃtʼɪ
ბუხარი	buxɑri	buχɑrɪ
ბუხჰალტერი	buxhɑltʼɛri	buχhɑltʼɛrɪ
ბჭისკარი	btʃʼiskʼɑri	btʃʼɪskʼɑrɪ
ბჰუტანი	bhutʼɑni	bhutʼɑnɪ
გააადამიანებს	ɡɑɑɑdɑmiɑnɛbs	ɡɑɑɑdɑmɪɑnɛbs
გააჩნია	ɡɑɑtʃniɑ	ɡɑɑtʃnɪɑ
გაბაშვილი	ɡɑbɑʃvili	ɡɑbɑʃvɪlɪ
გაბედული	ɡɑbɛduli	ɡɑbɛdulɪ
გაბზარული	ɡɑbzɑruli	ɡɑbzɑrulɪ
გაბიაბრუება	ɡɑbiɑbruɛbɑ	ɡɑbɪɑbruɛbɑ
გაბნეული	ɡɑbnɛuli	ɡɑbnɛulɪ
გაბონი	ɡɑbɔni	ɡɑbɔnɪ
გაბრაზებული	ɡɑbrɑzɛbuli	ɡɑbrɑzɛbulɪ
გაგიმარჯოს	ɡɑɡimɑrdʒɔs	ɡɑɡɪmɑrdʒɔs
გადააღწევს	ɡɑdɑɑɣtsʼɛvs	ɡɑdɑɑʁtsʼɛvs
გადაიხდის	ɡɑdɑixdis	ɡɑdɑɪχdɪs
გადამდგარი	ɡɑdɑmdɡɑri	ɡɑdɑmdɡɑrɪ
გადარეული	ɡɑdɑrɛuli	ɡɑdɑrɛulɪ
გადასახადი	ɡɑdɑsɑxɑdi	ɡɑdɑsɑχɑdɪ
გადასინჯავს	ɡɑdɑsindʒɑvs	ɡɑdɑsɪndʒɑvs
გადატანილი	ɡɑdɑtʼɑnili	ɡɑdɑtʼɑnɪlɪ
გადაუხდელი	ɡɑdɑuxdɛli	ɡɑdɑuχdɛlɪ
გადაუხდელობა	ɡɑdɑuxdɛlɔbɑ	ɡɑdɑuχdɛlɔbɑ
გადაღეჭილი	ɡɑdɑɣɛtʃʼili	ɡɑdɑʁɛtʃʼɪlɪ
გადახდა	ɡɑdɑxdɑ	ɡɑdɑχdɑ
გადის	ɡɑdis	ɡɑdɪs
გადმონაშთი	ɡɑdmɔnɑʃtʰi	ɡɑdmɔnɑʃtʰɪ
გადმოსაკონტრრევოლუციონერებლებისნაირებისათვისაცო	ɡɑdmɔsɑkʼɔntʼrrɛvɔlutsiɔnɛrɛblɛbisnɑirɛbisɑtʰvisɑtsɔ	ɡɑdmɔsɑkʼɔntʼrrɛvɔlutsɪɔnɛrɛblɛbɪsnɑɪrɛbɪsɑtʰvɪsɑtsɔ
გადოლინიუმი	ɡɑdɔliniumi	ɡɑdɔlɪnɪumɪ
გაერთიანებული	ɡɑɛrtʰiɑnɛbuli	ɡɑɛrtʰɪɑnɛbulɪ
გაეღვიძება	ɡɑɛɣvidzɛbɑ	ɡɑɛʁvɪdzɛbɑ
გავრცელებული	ɡɑvrtsɛlɛbuli	ɡɑvrtsɛlɛbulɪ
გაზაფხული	ɡɑzɑpʰxuli	ɡɑzɑpʰχulɪ
გაიანა	ɡɑiɑnɑ	ɡɑɪɑnɑ
გაისად	ɡɑisɑd	ɡɑɪsɑd
გაიძვერა	ɡɑidzvɛrɑ	ɡɑɪdzvɛrɑ
გაკეთებული	ɡɑkʼɛtʰɛbuli	ɡɑkʼɛtʰɛbulɪ
გაკვეთილი	ɡɑkʼvɛtʰili	ɡɑkʼvɛtʰɪlɪ
გალვანური	ɡɑlvɑnuri	ɡɑlvɑnurɪ
გალიონი	ɡɑliɔni	ɡɑlɪɔnɪ
გალიუმი	ɡɑliumi	ɡɑlɪumɪ
გალუმპული	ɡɑlumpʼuli	ɡɑlumpʼulɪ
გამათბობელი	ɡɑmɑtʰbɔbɛli	ɡɑmɑtʰbɔbɛlɪ
გამართული	ɡɑmɑrtʰuli	ɡɑmɑrtʰulɪ
გამაუპატიურებელი	ɡɑmɑupʼɑtʼiurɛbɛli	ɡɑmɑupʼɑtʼɪurɛbɛlɪ
გამბედავი	ɡɑmbɛdɑvi	ɡɑmbɛdɑvɪ
გამბია	ɡɑmbiɑ	ɡɑmbɪɑ
გამოითქმის	ɡɑmɔitʰkʰmis	ɡɑmɔɪtʰkʰmɪs
გამოიკითხავს	ɡɑmɔikʼitʰxɑvs	ɡɑmɔɪkʼɪtʰχɑvs
გამომდინარე	ɡɑmɔmdinɑrɛ	ɡɑmɔmdɪnɑrɛ
გამომცდელი	ɡɑmɔmtsdɛli	ɡɑmɔmtsdɛlɪ
გამონაშვერი	ɡɑmɔnɑʃvɛri	ɡɑmɔnɑʃvɛrɪ
გამორჩეული	ɡɑmɔrtʃɛuli	ɡɑmɔrtʃɛulɪ
გამოსადეგი	ɡɑmɔsɑdɛɡi	ɡɑmɔsɑdɛɡɪ
გამოსასყიდი	ɡɑmɔsɑsqʼidi	ɡɑmɔsɑsqʼɪdɪ
გამოსაცდელი	ɡɑmɔsɑtsdɛli	ɡɑmɔsɑtsdɛlɪ
გამოსახავს	ɡɑmɔsɑxɑvs	ɡɑmɔsɑχɑvs
გამოსყიდვა	ɡɑmɔsqʼidvɑ	ɡɑmɔsqʼɪdvɑ
გამოტვინებული	ɡɑmɔtʼvinɛbuli	ɡɑmɔtʼvɪnɛbulɪ
გამოუთქმელი	ɡɑmɔutʰkʰmɛli	ɡɑmɔutʰkʰmɛlɪ
გამოუცდელი	ɡɑmɔutsdɛli	ɡɑmɔutsdɛlɪ
გამოყენებული	ɡɑmɔqʼɛnɛbuli	ɡɑmɔqʼɛnɛbulɪ
გამოშვერილი	ɡɑmɔʃvɛrili	ɡɑmɔʃvɛrɪlɪ
გამოშტერებული	ɡɑmɔʃtʼɛrɛbuli	ɡɑmɔʃtʼɛrɛbulɪ
გამოჩენილი	ɡɑmɔtʃɛnili	ɡɑmɔtʃɛnɪlɪ
გამოჩენილობა	ɡɑmɔtʃɛnilɔbɑ	ɡɑmɔtʃɛnɪlɔbɑ
გამოცდილება	ɡɑmɔtsdilɛbɑ	ɡɑmɔtsdɪlɛbɑ
გამოცხობა	ɡɑmɔtsxɔbɑ	ɡɑmɔtsχɔbɑ
გამოხატავს	ɡɑmɔxɑtʼɑvs	ɡɑmɔχɑtʼɑvs
გამსახურდია	ɡɑmsɑxurdiɑ	ɡɑmsɑχurdɪɑ
გამჭრიახი	ɡɑmtʃʼriɑxi	ɡɑmtʃʼrɪɑχɪ
გამჭრიახობა	ɡɑmtʃʼriɑxɔbɑ	ɡɑmtʃʼrɪɑχɔbɑ
გამხდარი	ɡɑmxdɑri	ɡɑmχdɑrɪ
განაცხადებს	ɡɑnɑtsxɑdɛbs	ɡɑnɑtsχɑdɛbs
განაწილება	ɡɑnɑtsʼilɛbɑ	ɡɑnɑtsʼɪlɛbɑ
განგაში	ɡɑnɡɑʃi	ɡɑnɡɑʃɪ
განგმირვა	ɡɑnɡmirvɑ	ɡɑnɡmɪrvɑ
განებივრებული	ɡɑnɛbivrɛbuli	ɡɑnɛbɪvrɛbulɪ
განთიადი	ɡɑntʰiɑdi	ɡɑntʰɪɑdɪ
განიცდის	ɡɑnitsdis	ɡɑnɪtsdɪs
განმარტებითი	ɡɑnmɑrtʼɛbitʰi	ɡɑnmɑrtʼɛbɪtʰɪ
განსაზღვრავს	ɡɑnsɑzɣvrɑvs	ɡɑnsɑzʁvrɑvs
განსაკუთრებული	ɡɑnsɑkʼutʰrɛbuli	ɡɑnsɑkʼutʰrɛbulɪ
განსხვავება	ɡɑnsxvɑvɛbɑ	ɡɑnsχvɑvɛbɑ
განსხვავებული	ɡɑnsxvɑvɛbuli	ɡɑnsχvɑvɛbulɪ
განუხორციელებელი	ɡɑnuxɔrtsiɛlɛbɛli	ɡɑnuχɔrtsɪɛlɛbɛlɪ
განცალკევებით	ɡɑntsɑlkʼɛvɛbitʰ	ɡɑntsɑlkʼɛvɛbɪtʰ
განძი	ɡandzi	ɡandzɪ
განხეთქილება	ɡɑnxɛtʰkʰilɛbɑ	ɡɑnχɛtʰkʰɪlɛbɑ
განხილვა	ɡɑnxilvɑ	ɡɑnχɪlvɑ
გარგარი	ɡɑrɡɑri	ɡɑrɡɑrɪ
გარდამავალი	ɡɑrdɑmɑvɑli	ɡɑrdɑmɑvɑlɪ
გარდაცვლილი	ɡɑrdɑtsvlili	ɡɑrdɑtsvlɪlɪ
გარეგანი	ɡɑrɛɡɑni	ɡɑrɛɡɑnɪ
გარეგნული	ɡɑrɛɡnuli	ɡɑrɛɡnulɪ
გართულებული	ɡɑrtʰulɛbuli	ɡɑrtʰulɛbulɪ
გარიჟრაჟი	ɡɑriʒrɑʒi	ɡɑrɪʒrɑʒɪ
გარკვეული	ɡɑrkʼvɛuli	ɡɑrkʼvɛulɪ
გასავლიანი	ɡɑsɑvliɑni	ɡɑsɑvlɪɑnɪ
გასასვლელი	ɡɑsɑsvlɛli	ɡɑsɑsvlɛlɪ
გასაჭირი	ɡɑsɑtʃʼiri	ɡɑsɑtʃʼɪrɪ
გასინჯვა	ɡɑsindʒvɑ	ɡɑsɪndʒvɑ
გასული	ɡɑsuli	ɡɑsulɪ
გასწვრივ	ɡɑstsʼvriv	ɡɑstsʼvrɪv
გაფიცვა	ɡɑpʰitsvɑ	ɡɑpʰɪtsvɑ
გაფუჭებული	ɡɑpʰutʃʼɛbuli	ɡɑpʰutʃʼɛbulɪ
გაყიდვა	ɡɑqʼidvɑ	ɡɑqʼɪdvɑ
გაშლილი	ɡɑʃlili	ɡɑʃlɪlɪ
გაჩეჩილი	ɡɑtʃɛtʃili	ɡɑtʃɛtʃɪlɪ
გაჩითული	ɡɑtʃitʰuli	ɡɑtʃɪtʰulɪ
გაწყალებული	ɡɑtsʼqʼɑlɛbuli	ɡɑtsʼqʼɑlɛbulɪ
გახნის	ɡɑxnis	ɡɑχnɪs
გედი	ɡɛdi	ɡɛdɪ
გეი	ɡɛi	ɡɛɪ
გელაქნური	ɡɛlɑkʰnuri	ɡɛlɑkʰnurɪ
გემოვნებით	ɡɛmɔvnɛbitʰ	ɡɛmɔvnɛbɪtʰ
გემრიელი	ɡɛmriɛli	ɡɛmrɪɛlɪ
გენერაციული	ɡɛnɛrɑtsiuli	ɡɛnɛrɑtsɪulɪ
გენეტიკური	ɡɛnɛtʼikʼuri	ɡɛnɛtʼɪkʼurɪ
გეოგრაფიული	ɡɛɔɡrɑpʰiuli	ɡɛɔɡrɑpʰɪulɪ
გეოლოგიური	ɡɛɔlɔɡiuri	ɡɛɔlɔɡɪurɪ
გეომეტრიული	ɡɛɔmɛtʼriuli	ɡɛɔmɛtʼrɪulɪ
გეოცენტრული	ɡɛɔtsɛntʼruli	ɡɛɔtsɛntʼrulɪ
გერი	ɡɛri	ɡɛrɪ
გერმანია	ɡɛrmɑniɑ	ɡɛrmɑnɪɑ
გერმანიუმი	ɡɛrmɑniumi	ɡɛrmɑnɪumɪ
გესლიანი	ɡɛsliɑni	ɡɛslɪɑnɪ
გვალვიანობა	ɡvɑlviɑnɔbɑ	ɡvɑlvɪɑnɔbɑ
გვამი	ɡvɑmi	ɡvɑmɪ
გვარი	ɡvɑri	ɡvɑrɪ
გვარლი	ɡvɑrli	ɡvɑrlɪ
გველეშაპი	ɡvɛlɛʃɑpʼi	ɡvɛlɛʃɑpʼɪ
გველი	ɡvɛli	ɡvɛlɪ
გვერდი	ɡvɛrdi	ɡvɛrdɪ
გვერდითი	ɡvɛrditʰi	ɡvɛrdɪtʰɪ
გვიანი	ɡviɑni	ɡvɪɑnɪ
გვიმრა	ɡvimrɑ	ɡvɪmrɑ
გვიმრები	ɡvimrɛbi	ɡvɪmrɛbɪ
გვინეა	ɡvinɛɑ	ɡvɪnɛɑ
გვირგვინი	ɡvirɡvini	ɡvɪrɡvɪnɪ
გვფრცქვნი	ɡvpʰrtskʰvni	ɡvpʰrtskʰvnɪ
გვფრცქვნით	ɡvpʰrtskʰvnitʰ	ɡvpʰrtskʰvnɪtʰ
გზატკეცილი	ɡzɑtʼkʼɛtsili	ɡzɑtʼkʼɛtsɪlɪ
გზისპირი	ɡzispʼiri	ɡzɪspʼɪrɪ
გთხოვთ	ɡtʰxɔvtʰ	ɡtʰχɔvtʰ
გია	ɡiɑ	ɡɪɑ
გიგანტური	ɡiɡɑntʼuri	ɡɪɡɑntʼurɪ
გივი	ɡivi	ɡɪvɪ
გილოცავ	ɡilɔtsɑv	ɡɪlɔtsɑv
გინება	ɡinɛbɑ	ɡɪnɛbɑ
გიო	ɡiɔ	ɡɪɔ
გიორგი	ɡiɔrɡi	ɡɪɔrɡɪ
გიჟი	ɡiʒi	ɡɪʒɪ
გიჟივით	ɡiʒivitʰ	ɡɪʒɪvɪtʰ
გიჟური	ɡiʒuri	ɡɪʒurɪ
გირაგი	ɡirɑɡi	ɡɪrɑɡɪ
გირაო	ɡirɑɔ	ɡɪrɑɔ
გიშერი	ɡiʃɛri	ɡɪʃɛrɪ
გლეხები	ɡlɛxɛbi	ɡlɛχɛbɪ
გლეხი	ɡlɛxi	ɡlɛχɪ
გლეხობა	ɡlɛxɔbɑ	ɡlɛχɔbɑ
გმირი	ɡmiri	ɡmɪrɪ
გმირობა	ɡmirɔbɑ	ɡmɪrɔbɑ
გობი	ɡɔbi	ɡɔbɪ
გოგირდი	ɡɔɡirdi	ɡɔɡɪrdɪ
გოგოები	ɡɔɡɔɛbi	ɡɔɡɔɛbɪ
გოგოებით	ɡɔɡɔɛbitʰ	ɡɔɡɔɛbɪtʰ
გოგოების	ɡɔɡɔɛbis	ɡɔɡɔɛbɪs
გოგონი	ɡɔɡɔni	ɡɔɡɔnɪ
გოთვერანი	ɡɔtʰvɛrɑni	ɡɔtʰvɛrɑnɪ
გოიმი	ɡɔimi	ɡɔɪmɪ
გომი	ɡɔmi	ɡɔmɪ
გომური	ɡɔmuri	ɡɔmurɪ
გონაშვილი	ɡɔnɑʃvili	ɡɔnɑʃvɪlɪ
გონგი	ɡɔnɡi	ɡɔnɡɪ
გონივრული	ɡɔnivruli	ɡɔnɪvrulɪ
გონივრულობა	ɡɔnivrulɔbɑ	ɡɔnɪvrulɔbɑ
გორგალი	ɡɔrɡɑli	ɡɔrɡɑlɪ
გორი	ɡɔri	ɡɔrɪ
გრადუსი	ɡrɑdusi	ɡrɑdusɪ
გრამატიკა	ɡrɑmɑtʼikʼɑ	ɡrɑmɑtʼɪkʼɑ
გრამატიკული	ɡrɑmɑtʼikʼuli	ɡrɑmɑtʼɪkʼulɪ
გრაფიკული	ɡrɑpʰikʼuli	ɡrɑpʰɪkʼulɪ
გრგვინვა	ɡrɡvinvɑ	ɡrɡvɪnvɑ
გრეხა	ɡrɛxɑ	ɡrɛχɑ
გრიგალი	ɡriɡɑli	ɡrɪɡɑlɪ
გრიგოლ	ɡriɡɔl	ɡrɪɡɔl
გრიგოლი	ɡriɡɔli	ɡrɪɡɔlɪ
გრილი	ɡrili	ɡrɪlɪ
გრიმი	ɡrimi	ɡrɪmɪ
გრუხუნი	ɡruxuni	ɡruχunɪ
გრძელი	ɡrdzɛli	ɡrdzɛlɪ
გრძნეული	ɡrdznɛuli	ɡrdznɛulɪ
გრძნობადი	ɡrdznɔbɑdi	ɡrdznɔbɑdɪ
გუამი	ɡuɑmi	ɡuɑmɪ
გუგლი	ɡuɡli	ɡuɡlɪ
გუგული	ɡuɡuli	ɡuɡulɪ
გუდასტვირი	ɡudɑstʼviri	ɡudɑstʼvɪrɪ
გუთანი	ɡutʰɑni	ɡutʰɑnɪ
გუთური	ɡutʰuri	ɡutʰurɪ
გულადი	ɡulɑdi	ɡulɑdɪ
გულახდილად	ɡulɑxdilɑd	ɡulɑχdɪlɑd
გულახდილი	ɡulɑxdili	ɡulɑχdɪlɪ
გულახდილობა	ɡulɑxdilɔbɑ	ɡulɑχdɪlɔbɑ
გულგასახეთქი	ɡulɡɑsɑxɛtʰkʰi	ɡulɡɑsɑχɛtʰkʰɪ
გულგატეხილი	ɡulɡɑtʼɛxili	ɡulɡɑtʼɛχɪlɪ
გულგაწყალებული	ɡulɡɑtsʼqʼɑlɛbuli	ɡulɡɑtsʼqʼɑlɛbulɪ
გულგრილი	ɡulɡrili	ɡulɡrɪlɪ
გულგრილობა	ɡulɡrilɔbɑ	ɡulɡrɪlɔbɑ
გულთბილი	ɡultʰbili	ɡultʰbɪlɪ
გული	ɡuli	ɡulɪ
გულითადი	ɡulitʰɑdi	ɡulɪtʰɑdɪ
გულითადობა	ɡulitʰɑdɔbɑ	ɡulɪtʰɑdɔbɑ
გულისწვა	ɡulistsʼvɑ	ɡulɪstsʼvɑ
გულკეთილი	ɡulkʼɛtʰili	ɡulkʼɛtʰɪlɪ
გულკეთილობა	ɡulkʼɛtʰilɔbɑ	ɡulkʼɛtʰɪlɔbɑ
გულმავიწყი	ɡulmɑvitsʼqʼi	ɡulmɑvɪtsʼqʼɪ
გულმავიწყობა	ɡulmɑvitsʼqʼɔbɑ	ɡulmɑvɪtsʼqʼɔbɑ
გულმკერდი	ɡulmkʼɛrdi	ɡulmkʼɛrdɪ
გულმოდგინე	ɡulmɔdɡinɛ	ɡulmɔdɡɪnɛ
გულოვანი	ɡulɔvɑni	ɡulɔvɑnɪ
გულსაფარი	ɡulsɑpʰɑri	ɡulsɑpʰɑrɪ
გულუბრყვილო	ɡulubrqʼvilɔ	ɡulubrqʼvɪlɔ
გულუბრყვილოდ	ɡulubrqʼvilɔd	ɡulubrqʼvɪlɔd
გულუხვად	ɡuluxvɑd	ɡuluχvɑd
გულუხვი	ɡuluxvi	ɡuluχvɪ
გულუხვობა	ɡuluxvɔbɑ	ɡuluχvɔbɑ
გულჩათხრობილი	ɡultʃɑtʰxrɔbili	ɡultʃɑtʰχrɔbɪlɪ
გულცივი	ɡultsivi	ɡultsɪvɪ
გულწრფელი	ɡultsʼrpʰɛli	ɡultsʼrpʰɛlɪ
გურია	ɡuriɑ	ɡurɪɑ
გუტაპერჩი	ɡutʼɑpʼɛrtʃi	ɡutʼɑpʼɛrtʃɪ
გუშაგი	ɡuʃɑɡi	ɡuʃɑɡɪ
დაბადებული	dɑbɑdɛbuli	dɑbɑdɛbulɪ
დაბალი	dɑbɑli	dɑbɑlɪ
დაბნეული	dɑbnɛuli	dɑbnɛulɪ
დაგვიანებული	dɑɡviɑnɛbuli	dɑɡvɪɑnɛbulɪ
დადებითი	dɑdɛbitʰi	dɑdɛbɪtʰɪ
დადის	dɑdis	dɑdɪs
დავამარცხე	dɑvɑmɑrtsxɛ	dɑvɑmɑrtsχɛ
დავთარი	dɑvtʰɑri	dɑvtʰɑrɪ
დავით	dɑvitʰ	dɑvɪtʰ
დავითაშვილი	dɑvitʰɑʃvili	dɑvɪtʰɑʃvɪlɪ
დავიწყე	dɑvitsʼqʼɛ	dɑvɪtsʼqʼɛ
დავლური	dɑvluri	dɑvlurɪ
დაზღვევა	dɑzɣvɛvɑ	dɑzʁvɛvɑ
დათარიღებული	dɑtʰɑriɣɛbuli	dɑtʰɑrɪʁɛbulɪ
დათვი	dɑtʰvi	dɑtʰvɪ
დაიკიდე	dɑikʼidɛ	dɑɪkʼɪdɛ
დაისვენებს	dɑisvɛnɛbs	dɑɪsvɛnɛbs
დაიწყე	dɑitsʼqʼɛ	dɑɪtsʼqʼɛ
დაიწყო	dɑitsʼqʼɔ	dɑɪtsʼqʼɔ
დაკარგული	dɑkʼɑrɡuli	dɑkʼɑrɡulɪ
დაკლაკნილი	dɑkʼlɑkʼnili	dɑkʼlɑkʼnɪlɪ
დაკლაკნილობა	dɑkʼlɑkʼnilɔbɑ	dɑkʼlɑkʼnɪlɔbɑ
დამალული	dɑmɑluli	dɑmɑlulɪ
დამარცხება	dɑmɑrtsxɛbɑ	dɑmɑrtsχɛbɑ
დამატებით	dɑmɑtʼɛbitʰ	dɑmɑtʼɛbɪtʰ
დამატებითი	dɑmɑtʼɛbitʰi	dɑmɑtʼɛbɪtʰɪ
დამდგარი	dɑmdɡɑri	dɑmdɡɑrɪ
დამოკიდებული	dɑmɔkʼidɛbuli	dɑmɔkʼɪdɛbulɪ
დამპალი	dɑmpʼɑli	dɑmpʼɑlɪ
დამრიგებელი	dɑmriɡɛbɛli	dɑmrɪɡɛbɛlɪ
დამსჯელი	dɑmsdʒɛli	dɑmsdʒɛlɪ
დამუშავებული	dɑmuʃɑvɛbuli	dɑmuʃɑvɛbulɪ
დამფუძნებელი	dɑmpʰudznɛbɛli	dɑmpʰudznɛbɛlɪ
დამღუპველი	dɑmɣupʼvɛli	dɑmʁupʼvɛlɪ
დამღუპველობა	dɑmɣupʼvɛlɔbɑ	dɑmʁupʼvɛlɔbɑ
დამშეული	dɑmʃɛuli	dɑmʃɛulɪ
დამცავი	dɑmtsɑvi	dɑmtsɑvɪ
დანაკი	dɑnɑkʼi	dɑnɑkʼɪ
დანაშაული	dɑnɑʃɑuli	dɑnɑʃɑulɪ
დანგრეული	dɑnɡrɛuli	dɑnɡrɛulɪ
დანდალუკი	dɑndɑlukʼi	dɑndɑlukʼɪ
დანდური	dɑnduri	dɑndurɪ
დანია	dɑniɑ	dɑnɪɑ
დანიშნული	dɑniʃnuli	dɑnɪʃnulɪ
დაოსიზმი	dɑɔsizmi	dɑɔsɪzmɪ
დაპირება	dɑpʼirɛbɑ	dɑpʼɪrɛbɑ
დარაჯი	dɑrɑdʒi	dɑrɑdʒɪ
დარბაზი	dɑrbɑzi	dɑrbɑzɪ
დარდი	dɑrdi	dɑrdɪ
დარიშხანი	dɑriʃxɑni	dɑrɪʃχɑnɪ
დარუბანდი	dɑrubɑndi	dɑrubɑndɪ
დარჩენილი	dɑrtʃɛnili	dɑrtʃɛnɪlɪ
დასავლეთი	dɑsɑvlɛtʰi	dɑsɑvlɛtʰɪ
დასასჯელი	dɑsɑsdʒɛli	dɑsɑsdʒɛlɪ
დასაშვები	dɑsɑʃvɛbi	dɑsɑʃvɛbɪ
დასახლებული	dɑsɑxlɛbuli	dɑsɑχlɛbulɪ
დასჯის	dɑsdʒis	dɑsdʒɪs
დაუინტერესებლად	dɑuintʼɛrɛsɛblɑd	dɑuɪntʼɛrɛsɛblɑd
დაუმორჩილებლობა	dɑumɔrtʃilɛblɔbɑ	dɑumɔrtʃɪlɛblɔbɑ
დაუსწრებელი	dɑustsʼrɛbɛli	dɑustsʼrɛbɛlɪ
დაუსჯელი	dɑusdʒɛli	dɑusdʒɛlɪ
დაუფარავი	dɑupʰɑrɑvi	dɑupʰɑrɑvɪ
დაუხატავი	dɑuxɑtʼɑvi	dɑuχɑtʼɑvɪ
დაქირავებული	dɑkʰirɑvɛbuli	dɑkʰɪrɑvɛbulɪ
დაღესტანი	dɑɣɛstʼɑni	dɑʁɛstʼɑnɪ
დაღეჭილი	dɑɣɛtʃʼili	dɑʁɛtʃʼɪlɪ
დაღვრემილი	dɑɣvrɛmili	dɑʁvrɛmɪlɪ
დაღვრემილობა	dɑɣvrɛmilɔbɑ	dɑʁvrɛmɪlɔbɑ
დაღი	dɑɣi	dɑʁɪ
დაღლილად	dɑɣlilɑd	dɑʁlɪlɑd
დაღლილი	dɑɣlili	dɑʁlɪlɪ
დაღლილობა	dɑɣlilɔbɑ	dɑʁlɪlɔbɑ
დაშლადი	dɑʃlɑdi	dɑʃlɑdɪ
დაჩი	dɑtʃi	dɑtʃɪ
დაცლილი	dɑtslili	dɑtslɪlɪ
დაცული	dɑtsuli	dɑtsulɪ
დაძაბული	dɑdzɑbuli	dɑdzɑbulɪ
დაწინდული	dɑtsʼinduli	dɑtsʼɪndulɪ
დაწყებითი	dɑtsʼqʼɛbitʰi	dɑtsʼqʼɛbɪtʰɪ
დახვეული	dɑxvɛuli	dɑχvɛulɪ
დახვეწილი	dɑxvɛtsʼili	dɑχvɛtsʼɪlɪ
დახვეწილობა	dɑxvɛtsʼilɔbɑ	dɑχvɛtsʼɪlɔbɑ
დახლი	dɑxli	dɑχlɪ
დახრილი	dɑxrili	dɑχrɪlɪ
დახრილობა	dɑxrilɔbɑ	dɑχrɪlɔbɑ
დახურული	dɑxuruli	dɑχurulɪ
დახშული	dɑxʃuli	dɑχʃulɪ
დები	dɛbi	dɛbɪ
დებილი	dɛbili	dɛbɪlɪ
დებილობა	dɛbilɔbɑ	dɛbɪlɔbɑ
დეგენერატი	dɛɡɛnɛrɑtʼi	dɛɡɛnɛrɑtʼɪ
დედააზრი	dɛdɑɑzri	dɛdɑɑzrɪ
დედაარსი	dɛdɑɑrsi	dɛdɑɑrsɪ
დედაზარდლი	dɛdɑzɑrdli	dɛdɑzɑrdlɪ
დედაკაცი	dɛdɑkʼɑtsi	dɛdɑkʼɑtsɪ
დედალი	dɛdɑli	dɛdɑlɪ
დედამიწა	dɛdɑmitsʼɑ	dɛdɑmɪtsʼɑ
დედანი	dɛdɑni	dɛdɑnɪ
დედაქალაქი	dɛdɑkʰɑlɑkʰi	dɛdɑkʰɑlɑkʰɪ
დედიკო	dɛdikʼɔ	dɛdɪkʼɔ
დედისერთა	dɛdisɛrtʰɑ	dɛdɪsɛrtʰɑ
დედიშობილა	dɛdiʃɔbilɑ	dɛdɪʃɔbɪlɑ
დედოფალი	dɛdɔpʰɑli	dɛdɔpʰɑlɪ
დევი	dɛvi	dɛvɪ
დეზერტირი	dɛzɛrtʼiri	dɛzɛrtʼɪrɪ
დეზერტირობა	dɛzɛrtʼirɔbɑ	dɛzɛrtʼɪrɔbɑ
დეკანატი	dɛkʼɑnɑtʼi	dɛkʼɑnɑtʼɪ
დელფინი	dɛlpʰini	dɛlpʰɪnɪ
დემონი	dɛmɔni	dɛmɔnɪ
დენთი	dɛntʰi	dɛntʰɪ
დენი	dɛni	dɛnɪ
დეტალური	dɛtʼɑluri	dɛtʼɑlurɪ
დეფექტი	dɛpʰɛkʰtʼi	dɛpʰɛkʰtʼɪ
დვალიშვილი	dvɑliʃvili	dvɑlɪʃvɪlɪ
დვრიტა	dvritʼɑ	dvrɪtʼɑ
დიაბეტი	diɑbɛtʼi	dɪɑbɛtʼɪ
დიადი	diɑdi	dɪɑdɪ
დიალექტი	diɑlɛkʰtʼi	dɪɑlɛkʰtʼɪ
დიალექტიკური	diɑlɛkʰtʼikʼuri	dɪɑlɛkʰtʼɪkʼurɪ
დიაღ	dɪax	dɪaχ
დიახ	diax	dɪaχ
დიდედა	didɛdɑ	dɪdɛdɑ
დიდი	didi	dɪdɪ
დიდმოწამე	didmɔtsʼɑmɛ	dɪdmɔtsʼɑmɛ
დიდოური	didɔuri	dɪdɔurɪ
დიდსულოვანი	didsulɔvɑni	dɪdsulɔvɑnɪ
დიდძალი	diddzɑli	dɪddzɑlɪ
დივანი	divɑni	dɪvɑnɪ
დიზაინი	dizɑini	dɪzɑɪnɪ
დილა	dilɑ	dɪlɑ
დიმიტრი	dimitʼri	dɪmɪtʼrɪ
დინამიკური	dinɑmikʼuri	dɪnɑmɪkʼurɪ
დინება	dinɛbɑ	dɪnɛbɑ
დინოზავრი	dinɔzɑvri	dɪnɔzɑvrɪ
დიპლომატიური	dipʼlɔmɑtʼiuri	dɪpʼlɔmɑtʼɪurɪ
დირექტორი	dirɛkʰtʼɔri	dɪrɛkʰtʼɔrɪ
დირექტორობა	dirɛkʰtʼɔrɔbɑ	dɪrɛkʰtʼɔrɔbɑ
დისპროზიუმი	dispʼrɔziumi	dɪspʼrɔzɪumɪ
დიფთერია	dipʰtʰɛriɑ	dɪpʰtʰɛrɪɑ
დიფუზიურად	dipʰuziurɑd	dɪpʰuzɪurɑd
დიფუზიური	dipʰuziuri	dɪpʰuzɪurɪ
დიქტატურა	dikʰtʼɑtʼurɑ	dɪkʰtʼɑtʼurɑ
დოინჯი	dɔindʒi	dɔɪndʒɪ
დოლაბი	dɔlɑbi	dɔlɑbɪ
დოლარი	dɔlɑri	dɔlɑrɪ
დოლი	dɔli	dɔlɪ
დომინიკა	dɔminikʼɑ	dɔmɪnɪkʼɑ
დომხალი	dɔmxɑli	dɔmχɑlɪ
დონკიხოტობა	dɔnkʼixɔtʼɔbɑ	dɔnkʼɪχɔtʼɔbɑ
დორბლი	dɔrbli	dɔrblɪ
დოყლაპია	dɔqʼlɑpʼiɑ	dɔqʼlɑpʼɪɑ
დრაგუნი	drɑɡuni	drɑɡunɪ
დრაკონული	drɑkʼɔnuli	drɑkʼɔnulɪ
დრეკადი	drɛkʼɑdi	drɛkʼɑdɪ
დროებით	drɔɛbitʰ	drɔɛbɪtʰ
დროებითი	drɔɛbitʰi	drɔɛbɪtʰɪ
დროის	drɔis	drɔɪs
დროული	drɔuli	drɔulɪ
დრუნჩი	druntʃi	druntʃɪ
დუმილი	dumili	dumɪlɪ
დღე	dɣɛ	dʁɛ
დღეები	dɣɛɛbi	dʁɛɛbɪ
დღევანდელი	dɣɛvɑndɛli	dʁɛvɑndɛlɪ
დღეს	dɣɛs	dʁɛs
დღეღამე	dɣɛɣɑmɛ	dʁɛʁɑmɛ
ებრაული	ɛbrɑuli	ɛbrɑulɪ
ეგეთი	ɛɡɛtʰi	ɛɡɛtʰɪ
ეგენი	ɛɡɛni	ɛɡɛnɪ
ეგვიპტე	ɛɡvipʼtʼɛ	ɛɡvɪpʼtʼɛ
ეგოისტი	ɛɡɔistʼi	ɛɡɔɪstʼɪ
ევასები	ɛvɑsɛbi	ɛvɑsɛbɪ
ევგენი	ɛvɡɛni	ɛvɡɛnɪ
ევერესტი	ɛvɛrɛstʼi	ɛvɛrɛstʼɪ
ევოლუციური	ɛvɔlutsiuri	ɛvɔlutsɪurɪ
ევროპიუმი	ɛvrɔpʼiumi	ɛvrɔpʼɪumɪ
ევქარისტია	ɛvkʰɑristʼiɑ	ɛvkʰɑrɪstʼɪɑ
ეთიოპია	ɛtʰiɔpʼiɑ	ɛtʰɪɔpʼɪɑ
ეთნიკურად	ɛtʰnikʼurɑd	ɛtʰnɪkʼurɑd
ეკალი	ɛkʼɑli	ɛkʼɑlɪ
ეკვადორი	ɛkʼvɑdɔri	ɛkʼvɑdɔrɪ
ეკლესია	ɛkʼlɛsiɑ	ɛkʼlɛsɪɑ
ეკლიანი	ɛkʼliɑni	ɛkʼlɪɑnɪ
ეკლიპტიკა	ɛkʼlipʼtʼikʼɑ	ɛkʼlɪpʼtʼɪkʼɑ
ეკონომია	ɛkʼɔnɔmiɑ	ɛkʼɔnɔmɪɑ
ეკონომიკური	ɛkʼɔnɔmikʼuri	ɛkʼɔnɔmɪkʼurɪ
ეკონომიური	ɛkʼɔnɔmiuri	ɛkʼɔnɔmɪurɪ
ეკონომიურობა	ɛkʼɔnɔmiurɔbɑ	ɛkʼɔnɔmɪurɔbɑ
ელეგიური	ɛlɛɡiuri	ɛlɛɡɪurɪ
ენაჩლუნგი	ɛnɑtʃlunɡi	ɛnɑtʃlunɡɪ
ენგური	ɛnɡuri	ɛnɡurɪ
ენები	ɛnɛbi	ɛnɛbɪ
ენოტი	ɛnɔtʼi	ɛnɔtʼɪ
ეპითეტი	ɛpʼitʰɛtʼi	ɛpʼɪtʰɛtʼɪ
ეპისკოპოსი	ɛpʼiskʼɔpʼɔsi	ɛpʼɪskʼɔpʼɔsɪ
ეპისტემოლოგია	ɛpʼistʼɛmɔlɔɡiɑ	ɛpʼɪstʼɛmɔlɔɡɪɑ
ერაყი	ɛrɑqʼi	ɛrɑqʼɪ
ერბიუმი	ɛrbiumi	ɛrbɪumɪ
ერევანი	ɛrɛvɑni	ɛrɛvɑnɪ
ერთადერთი	ɛrtʰɑdɛrtʰi	ɛrtʰɑdɛrtʰɪ
ერთგული	ɛrtʰɡuli	ɛrtʰɡulɪ
ერთდროული	ɛrtʰdrɔuli	ɛrtʰdrɔulɪ
ერთერთი	ɛrtʰɛrtʰi	ɛrtʰɛrtʰɪ
ერთი	ɛrtʰi	ɛrtʰɪ
ერთიანი	ɛrtʰiɑni	ɛrtʰɪɑnɪ
ერთიანობა	ɛrtʰiɑnɔbɑ	ɛrtʰɪɑnɔbɑ
ერთმხრივი	ɛrtʰmxrivi	ɛrtʰmχrɪvɪ
ერთნაირობა	ɛrtʰnɑirɔbɑ	ɛrtʰnɑɪrɔbɑ
ერთსულოვანი	ɛrtʰsulɔvɑni	ɛrtʰsulɔvɑnɪ
ერთსქესიანი	ɛrtʰskʰɛsiɑni	ɛrtʰskʰɛsɪɑnɪ
ერთფერი	ɛrtʰpʰɛri	ɛrtʰpʰɛrɪ
ერისთავი	ɛristʰɑvi	ɛrɪstʰɑvɪ
ერიტრეა	ɛritʼrɛɑ	ɛrɪtʼrɛɑ
ეროზია	ɛrɔziɑ	ɛrɔzɪɑ
ერქვანი	ɛrkʰvɑni	ɛrkʰvɑnɪ
ესეი	ɛsɛi	ɛsɛɪ
ესენი	ɛsɛni	ɛsɛnɪ
ესპანეთი	ɛspʼɑnɛtʰi	ɛspʼɑnɛtʰɪ
ესტონეთი	ɛstʼɔnɛtʰi	ɛstʼɔnɛtʰɪ
ეტიმოლოგია	ɛtʼimɔlɔɡiɑ	ɛtʼɪmɔlɔɡɪɑ
ეტლი	ɛtʼli	ɛtʼlɪ
ეტრატი	ɛtʼrɑtʼi	ɛtʼrɑtʼɪ
ეფექტი	ɛpʰɛkʰtʼi	ɛpʰɛkʰtʼɪ
ეფექტური	ɛpʰɛkʰtʼuri	ɛpʰɛkʰtʼurɪ
ეფუზია	ɛpʰuziɑ	ɛpʰuzɪɑ
ექვსი	ɛkʰvsi	ɛkʰvsɪ
ექვსკუთხა	ɛkʰvskʼutʰxɑ	ɛkʰvskʼutʰχɑ
ექთანი	ɛkʰtʰɑni	ɛkʰtʰɑnɪ
ექიმბაში	ɛkʰimbɑʃi	ɛkʰɪmbɑʃɪ
ექიმბაშობა	ɛkʰimbɑʃɔbɑ	ɛkʰɪmbɑʃɔbɑ
ექიმი	ɛkʰimi	ɛkʰɪmɪ
ექსპედიცია	ɛkʰspʼɛditsiɑ	ɛkʰspʼɛdɪtsɪɑ
ეშვი	ɛʃvi	ɛʃvɪ
ეშინია	ɛʃiniɑ	ɛʃɪnɪɑ
ეშმაკი	ɛʃmɑkʼi	ɛʃmɑkʼɪ
ეშმაკით	ɛʃmɑkʼitʰ	ɛʃmɑkʼɪtʰ
ეშმაკის	ɛʃmɑkʼis	ɛʃmɑkʼɪs
ეშხი	ɛʃxi	ɛʃχɪ
ეშხიანი	ɛʃxiɑni	ɛʃχɪɑnɪ
ეჭვი	ɛtʃʼvi	ɛtʃʼvɪ
ეჭვიანი	ɛtʃʼviɑni	ɛtʃʼvɪɑnɪ
ეჭვიანობა	ɛtʃʼviɑnɔbɑ	ɛtʃʼvɪɑnɔbɑ
ეხა	ɛxɑ	ɛχɑ
ეხლა	ɛxlɑ	ɛχlɑ
ეჯი	ɛdʒi	ɛdʒɪ
ვაგონი	vɑɡɔni	vɑɡɔnɪ
ვაზი	vɑzi	vɑzɪ
ვაი	vɑi	vɑɪ
ვაიმე	vɑimɛ	vɑɪmɛ
ვალდებული	vɑldɛbuli	vɑldɛbulɪ
ვალი	vɑli	vɑlɪ
ვალიშვილი	vɑliʃvili	vɑlɪʃvɪlɪ
ვამპირი	vɑmpʼiri	vɑmpʼɪrɪ
ვანადიუმი	vɑnɑdiumi	vɑnɑdɪumɪ
ვანი	vɑni	vɑnɪ
ვაჟი	vɑʒi	vɑʒɪ
ვაჟიშვილი	vɑʒiʃvili	vɑʒɪʃvɪlɪ
ვაჟკაცი	vɑʒkʼɑtsi	vɑʒkʼɑtsɪ
ვაჟკაცური	vɑʒkʼɑtsuri	vɑʒkʼɑtsurɪ
ვარგისი	vɑrɡisi	vɑrɡɪsɪ
ვარგისობა	vɑrɡisɔbɑ	vɑrɡɪsɔbɑ
ვარდანიძე	vɑrdɑnidzɛ	vɑrdɑnɪdzɛ
ვარდი	vɑrdi	vɑrdɪ
ვარდისფერი	vɑrdispʰɛri	vɑrdɪspʰɛrɪ
ვარსკვლავი	vɑrskʼvlɑvi	vɑrskʼvlɑvɪ
ვარშანიძე	vɑrʃɑnidzɛ	vɑrʃɑnɪdzɛ
ვაშინგტონი	vɑʃinɡtʼɔni	vɑʃɪnɡtʼɔnɪ
ვაშლი	vɑʃli	vɑʃlɪ
ვაცი	vɑtsi	vɑtsɪ
ვახო	vɑxɔ	vɑχɔ
ვახტანგი	vɑxtʼɑnɡi	vɑχtʼɑnɡɪ
ვახტანგური	vɑxtʼɑnɡuri	vɑχtʼɑnɡurɪ
ვახში	vɑxʃi	vɑχʃɪ
ველი	vɛli	vɛlɪ
ველოსიპედი	vɛlɔsipʼɛdi	vɛlɔsɪpʼɛdɪ
ველური	vɛluri	vɛlurɪ
ვენახი	vɛnɑxi	vɛnɑχɪ
ვენური	vɛnuri	vɛnurɪ
ვერაგი	vɛrɑɡi	vɛrɑɡɪ
ვერტიკალური	vɛrtʼikʼɑluri	vɛrtʼɪkʼɑlurɪ
ვერცხლი	vɛrtsxli	vɛrtsχlɪ
ვერცხლისფერი	vɛrtsxlispʰɛri	vɛrtsχlɪspʰɛrɪ
ვერცხლისწყალი	vɛrtsxlistsʼqʼɑli	vɛrtsχlɪstsʼqʼɑlɪ
ვერძი	vɛrdzi	vɛrdzɪ
ვერხვი	vɛrxvi	vɛrχvɪ
ვეფხისტყაოსანი	vɛpʰxistʼqʼɑɔsɑni	vɛpʰχɪstʼqʼɑɔsɑnɪ
ვეშაპი	vɛʃɑpʼi	vɛʃɑpʼɪ
ვეწევი	vɛtsʼɛvi	vɛtsʼɛvɪ
ვთქვი	vtʰkʰvi	vtʰkʰvɪ
ვიდრე	vidrɛ	vɪdrɛ
ვიეტნამი	viɛtʼnɑmi	vɪɛtʼnɑmɪ
ვითარება	vitʰɑrɛbɑ	vɪtʰɑrɛbɑ
ვითარებითი	vitʰɑrɛbitʰi	vɪtʰɑrɛbɪtʰɪ
ვითომ	vitʰɔm	vɪtʰɔm
ვიკიმედია	vikʼimɛdiɑ	vɪkʼɪmɛdɪɑ
ვიკიპედია	vikʼipʼɛdiɑ	vɪkʼɪpʼɛdɪɑ
ვიკიპედია	vikʼipʼɛdiɑ	vɪkʼɪpʼɛdɪɑ
ვიკიჰოლიკი	vɪ.kɪ.hɔ.lɪ.ki	vɪ.kɪ.hɔ.lɪ.kɪ
ვილნიუსი	vilniusi	vɪlnɪusɪ
ვინ	vin	vɪn
ვინები	vinɛbi	vɪnɛbɪ
ვინმე	vinmɛ	vɪnmɛ
ვიოლინო	viɔlinɔ	vɪɔlɪnɔ
ვირთხა	virtʰxɑ	vɪrtʰχɑ
ვირი	viri	vɪrɪ
ვირტუოზი	virtʼuɔzi	vɪrtʼuɔzɪ
ვირტუოზობა	virtʼuɔzɔbɑ	vɪrtʼuɔzɔbɑ
ვის	vis	vɪs
ვისვენებ	visvɛnɛb	vɪsvɛnɛb
ვისი	visi	vɪsɪ
ვიღაც	viɣɑts	vɪʁɑts
ვიწრო	vitsʼrɔ	vɪtsʼrɔ
ვნახე	vnɑxɛ	vnɑχɛ
ვოლფრამი	vɔlpʰrɑmi	vɔlpʰrɑmɪ
ვრცელი	vrtsɛli	vrtsɛlɪ
ვულგარული	vulɡɑruli	vulɡɑrulɪ
ვწუხვარ	vtsʼuxvɑr	vtsʼuχvɑr
ზადი	zɑdi	zɑdɪ
ზადიკი	zɑdikʼi	zɑdɪkʼɪ
ზადიკობა	zɑdikʼɔbɑ	zɑdɪkʼɔbɑ
ზავთი	zɑvtʰi	zɑvtʰɪ
ზავთიანი	zɑvtʰiɑni	zɑvtʰɪɑnɪ
ზავი	zɑvi	zɑvɪ
ზამბარაკი	zɑmbɑrɑkʼi	zɑmbɑrɑkʼɪ
ზამბარაკიანი	zɑmbɑrɑkʼiɑni	zɑmbɑrɑkʼɪɑnɪ
ზამბახი	zɑmbɑxi	zɑmbɑχɪ
ზამბახიძე	zɑmbɑxidzɛ	zɑmbɑχɪdzɛ
ზამბია	zɑmbiɑ	zɑmbɪɑ
ზამბურაკი	zɑmburɑkʼi	zɑmburɑkʼɪ
ზამთარი	zɑmtʰɑri	zɑmtʰɑrɪ
ზანზარით	zɑnzɑritʰ	zɑnzɑrɪtʰ
ზარალი	zɑrɑli	zɑrɑlɪ
ზარბაზანი	zɑrbɑzɑni	zɑrbɑzɑnɪ
ზარი	zɑri	zɑrɪ
ზარმაცი	zɑrmɑtsi	zɑrmɑtsɪ
ზაფხული	zɑpʰxuli	zɑpʰχulɪ
ზედმეტი	zɛdmɛtʼi	zɛdmɛtʼɪ
ზევსი	zɛvsi	zɛvsɪ
ზეთისცხება	zɛtʰistsxɛbɑ	zɛtʰɪstsχɛbɑ
ზელანდია	zɛlɑndiɑ	zɛlɑndɪɑ
ზეფირი	zɛpʰiri	zɛpʰɪrɪ
ზვავი	zvɑvi	zvɑvɪ
ზვარაკი	zvɑrɑkʼi	zvɑrɑkʼɪ
ზვარი	zvɑri	zvɑrɪ
ზვირთი	zvirtʰi	zvɪrtʰɪ
ზიარება	ziɑrɛbɑ	zɪɑrɛbɑ
ზიდვა	zidvɑ	zɪdvɑ
ზიზღი	zizɣi	zɪzʁɪ
ზიმბაბვე	zimbɑbvɛ	zɪmbɑbvɛ
ზმნიზედა	zmnizɛdɑ	zmnɪzɛdɑ
ზმნიზედური	zmnizɛduri	zmnɪzɛdurɪ
ზოგადი	zɔɡɑdi	zɔɡɑdɪ
ზოგი	zɔɡi	zɔɡɪ
ზოგიერთი	zɔɡiɛrtʰi	zɔɡɪɛrtʰɪ
ზომიერი	zɔmiɛri	zɔmɪɛrɪ
ზრდილობა	zrdilɔbɑ	zrdɪlɔbɑ
ზრდის	zrdis	zrdɪs
ზუგდიდი	zuɡdidi	zuɡdɪdɪ
ზუთხი	zutʰxi	zutʰχɪ
ზურაბი	zurɑbi	zurɑbɪ
ზურაბიშვილი	zurɑbiʃvili	zurɑbɪʃvɪlɪ
ზურგი	zurɡi	zurɡɪ
ზუსტი	zustʼi	zustʼɪ
ზღაპარი	zɣɑpʼɑri	zʁɑpʼɑrɪ
ზღვა	zɣvɑ	zʁvɑ
ზღმარტლი	zɣmɑrtʼli	zʁmɑrtʼlɪ
თაგვი	tʰɑɡvi	tʰɑɡvɪ
თაგვისფერი	tʰɑɡvispʰɛri	tʰɑɡvɪspʰɛrɪ
თავადი	tʰɑvɑdi	tʰɑvɑdɪ
თავაზიანი	tʰɑvɑziɑni	tʰɑvɑzɪɑnɪ
თავაზიანობა	tʰɑvɑziɑnɔbɑ	tʰɑvɑzɪɑnɔbɑ
თავანი	tʰɑvɑni	tʰɑvɑnɪ
თავგადასავალი	tʰɑvɡɑdɑsɑvɑli	tʰɑvɡɑdɑsɑvɑlɪ
თავდასხმა	tʰɑvdɑsxmɑ	tʰɑvdɑsχmɑ
თავი	tʰɑvi	tʰɑvɪ
თავისებური	tʰɑvisɛburi	tʰɑvɪsɛburɪ
თავისი	tʰɑvisi	tʰɑvɪsɪ
თავისუფალი	tʰɑvisupʰɑli	tʰɑvɪsupʰɑlɪ
თავისუფლება	tʰɑvisupʰlɛbɑ	tʰɑvɪsupʰlɛbɑ
თავსაფარი	tʰɑvsɑpʰɑri	tʰɑvsɑpʰɑrɪ
თავქუდმოგლეჯილი	tʰɑvkʰudmɔɡlɛdʒili	tʰɑvkʰudmɔɡlɛdʒɪlɪ
თავხედი	tʰɑvxɛdi	tʰɑvχɛdɪ
თავხედობა	tʰɑvxɛdɔbɑ	tʰɑvχɛdɔbɑ
თავხედური	tʰɑvxɛduri	tʰɑvχɛdurɪ
თათარიახნი	tʰɑtʰɑriɑxni	tʰɑtʰɑrɪɑχnɪ
თათბირი	tʰɑtʰbiri	tʰɑtʰbɪrɪ
თათი	tʰɑtʰi	tʰɑtʰɪ
თალგამი	tʰɑlɡɑmi	tʰɑlɡɑmɪ
თალიუმი	tʰɑliumi	tʰɑlɪumɪ
თამამი	tʰɑmɑmi	tʰɑmɑmɪ
თამაში	tʰɑmɑʃi	tʰɑmɑʃɪ
თანაბარი	tʰɑnɑbɑri	tʰɑnɑbɑrɪ
თანამგზავრი	tʰɑnɑmɡzɑvri	tʰɑnɑmɡzɑvrɪ
თანამშრომელი	tʰɑnɑmʃrɔmɛli	tʰɑnɑmʃrɔmɛlɪ
თანასწორი	tʰɑnɑstsʼɔri	tʰɑnɑstsʼɔrɪ
თანახმა	tʰɑnɑxmɑ	tʰɑnɑχmɑ
თასი	tʰɑsi	tʰɑsɪ
თაფლი	tʰɑpʰli	tʰɑpʰlɪ
თაფლუჭი	tʰɑpʰlutʃʼi	tʰɑpʰlutʃʼɪ
თაღი	tʰɑɣi	tʰɑʁɪ
თაღლითი	tʰɑɣlitʰi	tʰɑʁlɪtʰɪ
თაღლითობა	tʰɑɣlitʰɔbɑ	tʰɑʁlɪtʰɔbɑ
თაყაიშვილი	tʰɑqʼɑiʃvili	tʰɑqʼɑɪʃvɪlɪ
თბილი	tʰbili	tʰbɪlɪ
თბილისი	tʰbilisi	tʰbɪlɪsɪ
თეატრი	tʰɛɑtʼri	tʰɛɑtʼrɪ
თებერვალი	tʰɛbɛrvɑli	tʰɛbɛrvɑlɪ
თევზები	tʰɛvzɛbi	tʰɛvzɛbɪ
თევზი	tʰɛvzi	tʰɛvzɪ
თეთრეული	tʰɛtʰrɛuli	tʰɛtʰrɛulɪ
თეთრი	tʰɛtʰri	tʰɛtʰrɪ
თეთრყვავილა	tʰɛtʰrqʼvɑvilɑ	tʰɛtʰrqʼvɑvɪlɑ
თელავი	tʰɛlɑvi	tʰɛlɑvɪ
თეოდიცეა	tʰɛɔditsɛɑ	tʰɛɔdɪtsɛɑ
თეოსოფია	tʰɛɔsɔpʰiɑ	tʰɛɔsɔpʰɪɑ
თერთმეტი	tʰɛrtʰmɛtʼi	tʰɛrtʰmɛtʼɪ
თესლი	tʰɛsli	tʰɛslɪ
თექვსმეტი	tʰɛkʰvsmɛtʼi	tʰɛkʰvsmɛtʼɪ
თვალთახედვა	tʰvɑltʰɑxɛdvɑ	tʰvɑltʰɑχɛdvɑ
თვალი	tʰvɑli	tʰvɑlɪ
თვითმარქვია	tʰvitʰmɑrkʰviɑ	tʰvɪtʰmɑrkʰvɪɑ
თვითნება	tʰvitʰnɛbɑ	tʰvɪtʰnɛbɑ
თვითნებად	tʰvitʰnɛbɑd	tʰvɪtʰnɛbɑd
თვითონ	tʰvitʰɔn	tʰvɪtʰɔn
თვისება	tʰvisɛbɑ	tʰvɪsɛbɑ
თვისტომი	tʰvistʼɔmi	tʰvɪstʼɔmɪ
თვრამეტი	tʰvrɑmɛtʼi	tʰvrɑmɛtʼɪ
თიბავს	tʰibɑvs	tʰɪbɑvs
თიბვა	tʰibvɑ	tʰɪbvɑ
თივა	tʰivɑ	tʰɪvɑ
თითი	tʰitʰi	tʰɪtʰɪ
თითისტარი	tʰitʰistʼɑri	tʰɪtʰɪstʼɑrɪ
თითო	tʰitʰɔ	tʰɪtʰɔ
თითოეული	tʰitʰɔɛuli	tʰɪtʰɔɛulɪ
თინა	tʰinɑ	tʰɪnɑ
თინუსი	tʰinusi	tʰɪnusɪ
თირი	tʰiri	tʰɪrɪ
თირკმელი	tʰirkʼmɛli	tʰɪrkʼmɛlɪ
თიხა	tʰixɑ	tʰɪχɑ
თმიანი	tʰmiɑni	tʰmɪɑnɪ
თმიანობა	tʰmiɑnɔbɑ	tʰmɪɑnɔbɑ
თოვლი	tʰɔvli	tʰɔvlɪ
თოთხმეტი	tʰɔtʰxmɛtʼi	tʰɔtʰχmɛtʼɪ
თოლია	tʰɔliɑ	tʰɔlɪɑ
თორი	tʰɔri	tʰɔrɪ
თორიუმი	tʰɔriumi	tʰɔrɪumɪ
თორმეტი	tʰɔrmɛtʼi	tʰɔrmɛtʼɪ
თორნიკე	tʰɔrnikʼɛ	tʰɔrnɪkʼɛ
თოფი	tʰɔpʰi	tʰɔpʰɪ
თოფიანი	tʰɔpʰiɑni	tʰɔpʰɪɑnɪ
თოხი	tʰɔxi	tʰɔχɪ
თოჯინა	tʰɔdʒinɑ	tʰɔdʒɪnɑ
თრიალეთი	tʰriɑlɛtʰi	tʰrɪɑlɛtʰɪ
თრითინა	tʰritʰinɑ	tʰrɪtʰɪnɑ
თუთიყუში	tʰutʰiqʼuʃi	tʰutʰɪqʼuʃɪ
თულიუმი	tʰuliumi	tʰulɪumɪ
თუნუქი	tʰunukʰi	tʰunukʰɪ
თურქეთი	tʰurkʰɛtʰi	tʰurkʰɛtʰɪ
თურქმენეთი	tʰurkʰmɛnɛtʰi	tʰurkʰmɛnɛtʰɪ
თუშეთი	tʰuʃɛtʰi	tʰuʃɛtʰɪ
თქვენთვის	tʰkʰvɛntʰvis	tʰkʰvɛntʰvɪs
თქვენი	tʰkʰvɛni	tʰkʰvɛnɪ
თხა	tʰxɑ	tʰχɑ
თხელი	tʰxɛli	tʰχɛlɪ
თხემი	tʰxɛmi	tʰχɛmɪ
თხზავს	tʰxzɑvs	tʰχzɑvs
თხილამური	tʰxilɑmuri	tʰχɪlɑmurɪ
თხილი	tʰxili	tʰχɪlɪ
თხრილი	tʰxrili	tʰχrɪlɪ
თხუთმეტი	tʰxutʰmɛtʼi	tʰχutʰmɛtʼɪ
თხუნელა	tʰxunɛlɑ	tʰχunɛlɑ
ია	iɑ	ɪɑ
იავარი	iɑvɑri	ɪɑvɑrɪ
იავნანა	iɑvnɑnɑ	ɪɑvnɑnɑ
იაკი	iɑkʼi	ɪɑkʼɪ
იალბუზი	iɑlbuzi	ɪɑlbuzɪ
იამაიკა	iɑmɑikʼɑ	ɪɑmɑɪkʼɑ
იაპონია	iɑpʼɔniɑ	ɪɑpʼɔnɪɑ
იარა	iɑrɑ	ɪɑrɑ
იარაღი	iɑrɑɣi	ɪɑrɑʁɪ
იარენი	iɑrɛni	ɪɑrɛnɪ
იარლიყი	iɑrliqʼi	ɪɑrlɪqʼɪ
იატაკი	iɑtʼɑkʼi	ɪɑtʼɑkʼɪ
იაფი	iɑpʰi	ɪɑpʰɪ
იბერია	ibɛriɑ	ɪbɛrɪɑ
იგებს	iɡɛbs	ɪɡɛbs
იგი	iɡi	ɪɡɪ
იგივე	iɡivɛ	ɪɡɪvɛ
იდეალიზმი	idɛɑlizmi	ɪdɛɑlɪzmɪ
იდენტური	idɛntʼuri	ɪdɛntʼurɪ
იდენტურობა	idɛntʼurɔbɑ	ɪdɛntʼurɔbɑ
იდიოტი	idiɔtʼi	ɪdɪɔtʼɪ
იდიოტურად	idiɔtʼurɑd	ɪdɪɔtʼurɑd
იდიოტური	idiɔtʼuri	ɪdɪɔtʼurɪ
იები	iɛbi	ɪɛbɪ
იემენი	iɛmɛni	ɪɛmɛnɪ
იერარქია	iɛrɑrkʰiɑ	ɪɛrɑrkʰɪɑ
იერუსალიმი	iɛrusɑlimi	ɪɛrusɑlɪmɪ
იესო	iɛsɔ	ɪɛsɔ
ივანე	ivɑnɛ	ɪvɑnɛ
ივანიშვილი	ivɑniʃvili	ɪvɑnɪʃvɪlɪ
ივლისი	ivlisi	ɪvlɪsɪ
ივნისი	ivnisi	ɪvnɪsɪ
იზოტოპი	izɔtʼɔpʼi	ɪzɔtʼɔpʼɪ
ითესავს	itʰɛsɑvs	ɪtʰɛsɑvs
ითმენს	itʰmɛns	ɪtʰmɛns
ილაჯი	ilɑdʒi	ɪlɑdʒɪ
ილია	iliɑ	ɪlɪɑ
იმარჯვებს	imɑrdʒvɛbs	ɪmɑrdʒvɛbs
იმედი	imɛdi	ɪmɛdɪ
იმერეთი	imɛrɛtʰi	ɪmɛrɛtʰɪ
იმპერია	impʼɛriɑ	ɪmpʼɛrɪɑ
იმპორტერი	impʼɔrtʼɛri	ɪmpʼɔrtʼɛrɪ
იმპრესიონიზმი	impʼrɛsiɔnizmi	ɪmpʼrɛsɪɔnɪzmɪ
იმპულსური	impʼulsuri	ɪmpʼulsurɪ
იმპულსურობა	impʼulsurɔbɑ	ɪmpʼulsurɔbɑ
ინგლისი	inɡlisi	ɪnɡlɪsɪ
ინგლისური	inɡlisuri	ɪnɡlɪsurɪ
ინდიუმი	indiumi	ɪndɪumɪ
ინდოეთი	indɔɛtʰi	ɪndɔɛtʰɪ
ინდონეზია	indɔnɛziɑ	ɪndɔnɛzɪɑ
ინერტული	inɛrtʼuli	ɪnɛrtʼulɪ
ინერტულობა	inɛrtʼulɔbɑ	ɪnɛrtʼulɔbɑ
ინვალიდობა	invɑlidɔbɑ	ɪnvɑlɪdɔbɑ
ინვენტარი	invɛntʼɑri	ɪnvɛntʼɑrɪ
ინიციატივა	initsiɑtʼivɑ	ɪnɪtsɪɑtʼɪvɑ
ინსტრუმენტი	instʼrumɛntʼi	ɪnstʼrumɛntʼɪ
ინტენსიური	intʼɛnsiuri	ɪntʼɛnsɪurɪ
ინტერესი	intʼɛrɛsi	ɪntʼɛrɛsɪ
ინფრაწითელი	inpʰrɑtsʼitʰɛli	ɪnpʰrɑtsʼɪtʰɛlɪ
ინჩი	intʃi	ɪntʃɪ
იონოსფერო	iɔnɔspʰɛrɔ	ɪɔnɔspʰɛrɔ
იორდანია	iɔrdɑniɑ	ɪɔrdɑnɪɑ
იორი	iɔri	ɪɔrɪ
იორკშირი	iɔrkʼʃiri	ɪɔrkʼʃɪrɪ
იპარსავს	ipʼɑrsɑvs	ɪpʼɑrsɑvs
იპოვა	ipʼɔvɑ	ɪpʼɔvɑ
ირანი	irɑni	ɪrɑnɪ
ირანული	irɑnuli	ɪrɑnulɪ
ირბისი	irbisi	ɪrbɪsɪ
ირემი	irɛmi	ɪrɛmɪ
ირიბი	iribi	ɪrɪbɪ
ირლანდია	irlɑndiɑ	ɪrlɑndɪɑ
ირონია	irɔniɑ	ɪrɔnɪɑ
ირონიული	irɔniuli	ɪrɔnɪulɪ
ის	is	ɪs
ისანი	isɑni	ɪsɑnɪ
ისარი	isɑri	ɪsɑrɪ
ისე	isɛ	ɪsɛ
ისინი	isini	ɪsɪnɪ
ისლამი	islɑmi	ɪslɑmɪ
ისლანდია	islɑndiɑ	ɪslɑndɪɑ
ისპანახი	ispʼɑnɑxi	ɪspʼɑnɑχɪ
ისრაელი	isrɑɛli	ɪsrɑɛlɪ
ისტერია	istʼɛriɑ	ɪstʼɛrɪɑ
ისტერიული	istʼɛriuli	ɪstʼɛrɪulɪ
ისტორია	istʼɔriɑ	ɪstʼɔrɪɑ
ისტორიული	istʼɔriuli	ɪstʼɔrɪulɪ
იტერბიუმი	itʼɛrbiumi	ɪtʼɛrbɪumɪ
იტრიუმი	itʼriumi	ɪtʼrɪumɪ
იუპიტერი	iupʼitʼɛri	ɪupʼɪtʼɛrɪ
იფქლი	ipʰkʰli	ɪpʰkʰlɪ
იღბალი	iɣbɑli	ɪʁbɑlɪ
იყიდება	iqʼidɛbɑ	ɪqʼɪdɛbɑ
იყოს	iqʼɔs	ɪqʼɔs
იშელი	iʃɛli	ɪʃɛlɪ
იშვიათად	iʃviɑtʰɑd	ɪʃvɪɑtʰɑd
იშვიათი	iʃviɑtʰi	ɪʃvɪɑtʰɪ
იშვიათობა	iʃviɑtʰɔbɑ	ɪʃvɪɑtʰɔbɑ
იშიმბაი	iʃimbɑi	ɪʃɪmbɑɪ
იცით	itsitʰ	ɪtsɪtʰ
იცოცხლე	itsɔtsxlɛ	ɪtsɔtsχlɛ
იძულებითი	idzulɛbitʰi	ɪdzulɛbɪtʰɪ
იწყება	itsʼqʼɛbɑ	ɪtsʼqʼɛbɑ
იხდის	ixdis	ɪχdɪs
იხვი	ixvi	ɪχvɪ
იხილავს	ixilɑvs	ɪχɪlɑvs
კაბრიოლეტი	kʼɑbriɔlɛtʼi	kʼɑbrɪɔlɛtʼɪ
კადმიუმი	kʼɑdmiumi	kʼɑdmɪumɪ
კადნიერად	kʼɑdniɛrɑd	kʼɑdnɪɛrɑd
კადნიერი	kʼɑdniɛri	kʼɑdnɪɛrɪ
კავალერია	kʼɑvɑlɛriɑ	kʼɑvɑlɛrɪɑ
კავკასია	kʼɑvkʼɑsiɑ	kʼɑvkʼɑsɪɑ
კავკასიელი	kʼɑvkʼɑsiɛli	kʼɑvkʼɑsɪɛlɪ
კავკასიონი	kʼɑvkʼɑsiɔni	kʼɑvkʼɑsɪɔnɪ
კავკასიური	kʼɑvkʼɑsiuri	kʼɑvkʼɑsɪurɪ
კავშირი	kʼɑvʃiri	kʼɑvʃɪrɪ
კაზინო	kʼɑzinɔ	kʼɑzɪnɔ
კათხა	kʼɑtʰxɑ	kʼɑtʰχɑ
კაი	kʼɑi	kʼɑɪ
კაირო	kʼɑirɔ	kʼɑɪrɔ
კაიფი	kʼɑipʰi	kʼɑɪpʰɪ
კაკაბი	kʼɑkʼɑbi	kʼɑkʼɑbɪ
კაკალი	kʼɑkʼɑli	kʼɑkʼɑlɪ
კაკაშვილი	kʼɑkʼɑʃvili	kʼɑkʼɑʃvɪlɪ
კაკუნი	kʼɑkʼuni	kʼɑkʼunɪ
კალათი	kʼɑlɑtʰi	kʼɑlɑtʰɪ
კალამი	kʼɑlɑmi	kʼɑlɑmɪ
კალაპოტი	kʼɑlɑpʼɔtʼi	kʼɑlɑpʼɔtʼɪ
კალენდარი	kʼɑlɛndɑri	kʼɑlɛndɑrɪ
კალია	kʼɑliɑ	kʼɑlɪɑ
კალიუმი	kʼɑliumi	kʼɑlɪumɪ
კალიფორნია	kʼɑlipʰɔrniɑ	kʼɑlɪpʰɔrnɪɑ
კალკი	kʼɑlkʼi	kʼɑlkʼɪ
კალმახი	kʼɑlmɑxi	kʼɑlmɑχɪ
კალორია	kʼɑlɔriɑ	kʼɑlɔrɪɑ
კალციუმი	kʼɑltsiumi	kʼɑltsɪumɪ
კამათელი	kʼɑmɑtʰɛli	kʼɑmɑtʰɛlɪ
კამათი	kʼɑmɑtʰi	kʼɑmɑtʰɪ
კამერუნი	kʼɑmɛruni	kʼɑmɛrunɪ
კამეჩი	kʼɑmɛtʃi	kʼɑmɛtʃɪ
კანდიდატი	kʼɑndidɑtʼi	kʼɑndɪdɑtʼɪ
კანდიდატურა	kʼɑndidɑtʼurɑ	kʼɑndɪdɑtʼurɑ
კანონი	kʼɑnɔni	kʼɑnɔnɪ
კანონიერი	kʼɑnɔniɛri	kʼɑnɔnɪɛrɪ
კანცლერი	kʼɑntslɛri	kʼɑntslɛrɪ
კანჭი	kʼɑntʃʼi	kʼɑntʃʼɪ
კაპიკი	kʼɑpʼikʼi	kʼɑpʼɪkʼɪ
კაპიტალი	kʼɑpʼitʼɑli	kʼɑpʼɪtʼɑlɪ
კაპიტალიზმი	kʼɑpʼitʼɑlizmi	kʼɑpʼɪtʼɑlɪzmɪ
კაპიტულაცია	kʼɑpʼitʼulɑtsiɑ	kʼɑpʼɪtʼulɑtsɪɑ
კარავი	kʼɑrɑvi	kʼɑrɑvɪ
კარგი	kʼɑrɡi	kʼɑrɡɪ
კარები	kʼɑrɛbi	kʼɑrɛbɪ
კარი	kʼɑri	kʼɑrɪ
კარტი	kʼɑrtʼi	kʼɑrtʼɪ
კასრი	kʼɑsri	kʼɑsrɪ
კატაბანი	kʼɑtʼɑbɑni	kʼɑtʼɑbɑnɪ
კატარი	kʼɑtʼɑri	kʼɑtʼɑrɪ
კატაფალკი	kʼɑtʼɑpʰɑlkʼi	kʼɑtʼɑpʰɑlkʼɪ
კატეხიზმო	kʼɑtʼɛxizmɔ	kʼɑtʼɛχɪzmɔ
კატისებრი	kʼɑtʼisɛbri	kʼɑtʼɪsɛbrɪ
კატლეტი	kʼɑtʼlɛtʼi	kʼɑtʼlɛtʼɪ
კატორღა	kʼɑtʼɔrɣɑ	kʼɑtʼɔrʁɑ
კატუნი	kʼɑtʼuni	kʼɑtʼunɪ
კაური	kʼɑuri	kʼɑurɪ
კაუჩუკი	kʼɑutʃukʼi	kʼɑutʃukʼɪ
კაქტუსი	kʼɑkʰtʼusi	kʼɑkʰtʼusɪ
კაშხალი	kʼɑʃxɑli	kʼɑʃχɑlɪ
კაცებისებრ	kʼɑtsɛbisɛbr	kʼɑtsɛbɪsɛbr
კაცი	kʼɑtsi	kʼɑtsɪ
კაცით	kʼɑtsitʰ	kʼɑtsɪtʰ
კაცისებრ	kʼɑtsisɛbr	kʼɑtsɪsɛbr
კაცობრიობა	kʼɑtsɔbriɔbɑ	kʼɑtsɔbrɪɔbɑ
კაჭკაჭი	kʼɑtʃʼkʼɑtʃʼi	kʼɑtʃʼkʼɑtʃʼɪ
კახა	kʼɑxɑ	kʼɑχɑ
კახაბერი	kʼɑxɑbɛri	kʼɑχɑbɛrɪ
კახეთი	kʼɑxɛtʰi	kʼɑχɛtʰɪ
კახი	kʼɑxi	kʼɑχɪ
კბილი	kʼbili	kʼbɪlɪ
კედარი	kʼɛdɑri	kʼɛdɑrɪ
კედელი	kʼɛdɛli	kʼɛdɛlɪ
კედლები	kʼɛdlɛbi	kʼɛdlɛbɪ
კევი	kʼɛvi	kʼɛvɪ
კეთილდღეობა	kʼɛtʰildɣɛɔbɑ	kʼɛtʰɪldʁɛɔbɑ
კეთილთვისებიანი	kʼɛtʰiltʰvisɛbiɑni	kʼɛtʰɪltʰvɪsɛbɪɑnɪ
კეთილი	kʼɛtʰili	kʼɛtʰɪlɪ
კეთილშობილად	kʼɛtʰilʃɔbilɑd	kʼɛtʰɪlʃɔbɪlɑd
კეთილშობილი	kʼɛtʰilʃɔbili	kʼɛtʰɪlʃɔbɪlɪ
კეთროვანი	kʼɛtʰrɔvɑni	kʼɛtʰrɔvɑnɪ
კეკლუცი	kʼɛkʼlutsi	kʼɛkʼlutsɪ
კენარი	kʼɛnɑri	kʼɛnɑrɪ
კენია	kʼɛniɑ	kʼɛnɪɑ
კენჭი	kʼɛntʃʼi	kʼɛntʃʼɪ
კენჭისყრა	kʼɛntʃʼisqʼrɑ	kʼɛntʃʼɪsqʼrɑ
კერპი	kʼɛrpʼi	kʼɛrpʼɪ
კერძი	kʼɛrdzi	kʼɛrdzɪ
კვადრატი	kʼvɑdrɑtʼi	kʼvɑdrɑtʼɪ
კვალი	kʼvɑli	kʼvɑlɪ
კვამლი	kʼvɑmli	kʼvɑmlɪ
კვარცხლბეკი	kʼvɑrtsxlbɛkʼi	kʼvɑrtsχlbɛkʼɪ
კვერცხი	kʼvɛrtsxi	kʼvɛrtsχɪ
კვიპროსი	kʼvipʼrɔsi	kʼvɪpʼrɔsɪ
კვირა	kʼvirɑ	kʼvɪrɑ
კვირტი	kʼvirtʼi	kʼvɪrtʼɪ
კვიცი	kʼvitsi	kʼvɪtsɪ
კვლიავი	kʼvliɑvi	kʼvlɪɑvɪ
კი	kʼi	kʼɪ
კიანგი	kʼiɑnɡi	kʼɪɑnɡɪ
კიბო	kʼibɔ	kʼɪbɔ
კიბორჩხალა	kʼibɔrtʃxɑlɑ	kʼɪbɔrtʃχɑlɑ
კიგალი	kʼiɡɑli	kʼɪɡɑlɪ
კიდობანი	kʼidɔbɑni	kʼɪdɔbɑnɪ
კითხვა	kʼitʰxvɑ	kʼɪtʰχvɑ
კიმპალი	kʼimpʼɑli	kʼɪmpʼɑlɪ
კინეტიკური	kʼinɛtʼikʼuri	kʼɪnɛtʼɪkʼurɪ
კირიანი	kʼiriɑni	kʼɪrɪɑnɪ
კირიბატი	kʼiribɑtʼi	kʼɪrɪbɑtʼɪ
კირჩხიბი	kʼirtʃxibi	kʼɪrtʃχɪbɪ
კისერი	kʼisɛri	kʼɪsɛrɪ
კიჩო	kʼitʃɔ	kʼɪtʃɔ
კიცხავს	kʼitsxɑvs	kʼɪtsχɑvs
კლასი	kʼlɑsi	kʼlɑsɪ
კლიტე	kʼlitʼɛ	kʼlɪtʼɛ
კმაყოფილება	kʼmɑqʼɔpʰilɛbɑ	kʼmɑqʼɔpʰɪlɛbɑ
კმაყოფილი	kʼmɑqʼɔpʰili	kʼmɑqʼɔpʰɪlɪ
კნუტი	kʼnutʼi	kʼnutʼɪ
კობიაშვილი	kʼɔbiɑʃvili	kʼɔbɪɑʃvɪlɪ
კოეფიციენტი	kʼɔɛpʰitsiɛntʼi	kʼɔɛpʰɪtsɪɛntʼɪ
კოვბოი	kʼɔvbɔi	kʼɔvbɔɪ
კოვზი	kʼɔvzi	kʼɔvzɪ
კოკოტი	kʼɔkʼɔtʼi	kʼɔkʼɔtʼɪ
კოლოსალური	kʼɔlɔsɑluri	kʼɔlɔsɑlurɪ
კოლხეთი	kʼɔlxɛtʰi	kʼɔlχɛtʰɪ
კომერციული	kʼɔmɛrtsiuli	kʼɔmɛrtsɪulɪ
კომპაქტური	kʼɔmpʼɑkʰtʼuri	kʼɔmpʼɑkʰtʼurɪ
კომპლექსური	kʼɔmpʼlɛkʰsuri	kʼɔmpʼlɛkʰsurɪ
კომპრომისი	kʼɔmpʼrɔmisi	kʼɔmpʼrɔmɪsɪ
კომუნისტური	kʼɔmunistʼuri	kʼɔmunɪstʼurɪ
კონდიტერი	kʼɔnditʼɛri	kʼɔndɪtʼɛrɪ
კონსტანტინე	kʼɔnstʼɑntʼinɛ	kʼɔnstʼɑntʼɪnɛ
კონსული	kʼɔnsuli	kʼɔnsulɪ
კონტროლი	kʼɔntʼrɔli	kʼɔntʼrɔlɪ
კონტროლიორი	kʼɔntʼrɔliɔri	kʼɔntʼrɔlɪɔrɪ
კონცენტრული	kʼɔntsɛntʼruli	kʼɔntsɛntʼrulɪ
კონცხი	kʼɔntsxi	kʼɔntsχɪ
კოორდინატი	kʼɔɔrdinɑtʼi	kʼɔɔrdɪnɑtʼɪ
კოორდინაცია	kʼɔɔrdinɑtsiɑ	kʼɔɔrdɪnɑtsɪɑ
კოორდინირებს	kʼɔɔrdinirɛbs	kʼɔɔrdɪnɪrɛbs
კოპიო	kʼɔpʼiɔ	kʼɔpʼɪɔ
კორექცია	kʼɔrɛkʰtsiɑ	kʼɔrɛkʰtsɪɑ
კორპუსი	kʼɔrpʼusi	kʼɔrpʼusɪ
კოღო	kʼɔɣɔ	kʼɔʁɔ
კოშკი	kʼɔʃkʼi	kʼɔʃkʼɪ
კოშმარი	kʼɔʃmɑri	kʼɔʃmɑrɪ
კოჭლი	kʼɔtʃʼli	kʼɔtʃʼlɪ
კოჰაბიტაცია	kʼɔhɑbitʼɑtsiɑ	kʼɔhɑbɪtʼɑtsɪɑ
კრავი	kʼrɑvi	kʼrɑvɪ
კრემლი	kʼrɛmli	kʼrɛmlɪ
კრეოზოტი	kʼrɛɔzɔtʼi	kʼrɛɔzɔtʼɪ
კრეტინი	kʼrɛtʼini	kʼrɛtʼɪnɪ
კრიმანჭული	kʼrimɑntʃʼuli	kʼrɪmɑntʃʼulɪ
კრინოლინი	kʼrinɔlini	kʼrɪnɔlɪnɪ
კრიპტონი	kʼripʼtʼɔni	kʼrɪpʼtʼɔnɪ
კრიტიკა	kʼritʼikʼɑ	kʼrɪtʼɪkʼɑ
კრუტუნი	kʼrutʼuni	kʼrutʼunɪ
კრუხი	kʼruxi	kʼruχɪ
კუბური	kʼuburi	kʼuburɪ
კუდამოძუებული	kʼudɑmɔdzuɛbuli	kʼudɑmɔdzuɛbulɪ
კუდი	kʼudi	kʼudɪ
კუდიანი	kʼudiɑni	kʼudɪɑnɪ
კუზი	kʼuzi	kʼuzɪ
კუთვნილებითი	kʼutʰvnilɛbitʰi	kʼutʰvnɪlɛbɪtʰɪ
კუთხე	kʼutʰxɛ	kʼutʰχɛ
კულტი	kʼultʼi	kʼultʼɪ
კუნძული	kʼundzuli	kʼundzulɪ
კურდღელი	kʼurdɣɛli	kʼurdʁɛlɪ
კურიერი	kʼuriɛri	kʼurɪɛrɪ
კურორტი	kʼurɔrtʼi	kʼurɔrtʼɪ
კურწი	kʼurtsʼi	kʼurtsʼɪ
კუსი	kʼusi	kʼusɪ
კუშტი	kʼuʃtʼi	kʼuʃtʼɪ
კუჭი	kʼutʃʼi	kʼutʃʼɪ
ლაბირინთი	lɑbirintʰi	lɑbɪrɪntʰɪ
ლაგამი	lɑɡɑmi	lɑɡɑmɪ
ლავაში	lɑvɑʃi	lɑvɑʃɪ
ლათინური	lɑtʰinuri	lɑtʰɪnurɪ
ლაილაი	lɑilɑi	lɑɪlɑɪ
ლაკმუსი	lɑkʼmusi	lɑkʼmusɪ
ლაკონიურობა	lɑkʼɔniurɔbɑ	lɑkʼɔnɪurɔbɑ
ლამაზი	lɑmɑzi	lɑmɑzɪ
ლანთანი	lɑntʰɑni	lɑntʰɑnɪ
ლანძღავს	lɑndzɣɑvs	lɑndzʁɑvs
ლაოსი	lɑɔsi	lɑɔsɪ
ლაპარაკი	lɑpʼɑrɑkʼi	lɑpʼɑrɑkʼɪ
ლარი	lɑri	lɑrɪ
ლარისა	lɑrisɑ	lɑrɪsɑ
ლასურაშვილი	lɑsurɑʃvili	lɑsurɑʃvɪlɪ
ლატვია	lɑtʼviɑ	lɑtʼvɪɑ
ლაშქარი	lɑʃkʰɑri	lɑʃkʰɑrɪ
ლაჩარი	lɑtʃɑri	lɑtʃɑrɪ
ლახვარი	lɑxvɑri	lɑχvɑrɪ
ლებანი	lɛbɑni	lɛbɑnɪ
ლეგიონი	lɛɡiɔni	lɛɡɪɔnɪ
ლევანი	lɛvɑni	lɛvɑnɪ
ლეზვი	lɛzvi	lɛzvɪ
ლეკვეიშვილი	lɛkʼvɛiʃvili	lɛkʼvɛɪʃvɪlɪ
ლეკვი	lɛkʼvi	lɛkʼvɪ
ლენტი	lɛntʼi	lɛntʼɪ
ლეპტოპი	lɛpʼtʼɔpʼi	lɛpʼtʼɔpʼɪ
ლერწამი	lɛrtsʼɑmi	lɛrtsʼɑmɪ
ლექსი	lɛkʰsi	lɛkʰsɪ
ლექსიკონი	lɛkʰsikʼɔni	lɛkʰsɪkʼɔnɪ
ლექსიკური	lɛkʰsikʼuri	lɛkʰsɪkʼurɪ
ლეჩხუმი	lɛtʃxumi	lɛtʃχumɪ
ლიანდაგი	liɑndɑɡi	lɪɑndɑɡɪ
ლიბანი	libɑni	lɪbɑnɪ
ლიბერია	libɛriɑ	lɪbɛrɪɑ
ლიბია	libiɑ	lɪbɪɑ
ლიგა	liɡɑ	lɪɡɑ
ლიდერი	lidɛri	lɪdɛrɪ
ლიდერობა	lidɛrɔbɑ	lɪdɛrɔbɑ
ლიზა	lizɑ	lɪzɑ
ლიზი	lizi	lɪzɪ
ლითიუმი	litʰiumi	lɪtʰɪumɪ
ლითონი	litʰɔni	lɪtʰɔnɪ
ლიმონი	limɔni	lɪmɔnɪ
ლინგვისტიკა	linɡvistʼikʼɑ	lɪnɡvɪstʼɪkʼɑ
ლირიკული	lirikʼuli	lɪrɪkʼulɪ
ლიტვა	litʼvɑ	lɪtʼvɑ
ლიფი	lipʰi	lɪpʰɪ
ლიხტენშტაინი	lixtʼɛnʃtʼɑini	lɪχtʼɛnʃtʼɑɪnɪ
ლიხტენშტეინი	lixtʼɛnʃtʼɛini	lɪχtʼɛnʃtʼɛɪnɪ
ლობიანი	lɔbiɑni	lɔbɪɑnɪ
ლობიო	lɔbiɔ	lɔbɪɔ
ლოგინი	lɔɡini	lɔɡɪnɪ
ლოდი	lɔdi	lɔdɪ
ლოთი	lɔtʰi	lɔtʰɪ
ლომვეშაპი	lɔmvɛʃɑpʼi	lɔmvɛʃɑpʼɪ
ლომი	lɔmi	lɔmɪ
ლოურენსიუმი	lɔurɛnsiumi	lɔurɛnsɪumɪ
ლპობადი	lpʼɔbɑdi	lpʼɔbɑdɪ
ლუდი	ludi	ludɪ
ლუი	lui	luɪ
ლურსმანი	lursmɑni	lursmɑnɪ
ლუტეციუმი	lutʼɛtsiumi	lutʼɛtsɪumɪ
ლუქსემბურგი	lukʰsɛmburɡi	lukʰsɛmburɡɪ
ლხინი	lxini	lχɪnɪ
მაგალითად	mɑɡɑlitʰɑd	mɑɡɑlɪtʰɑd
მაგალითი	mɑɡɑlitʰi	mɑɡɑlɪtʰɪ
მაგარი	mɑɡɑri	mɑɡɑrɪ
მაგასი	mɑɡɑsi	mɑɡɑsɪ
მაგიდა	mɑɡidɑ	mɑɡɪdɑ
მაგისტრალი	mɑɡistʼrɑli	mɑɡɪstʼrɑlɪ
მაგნიტი	mɑɡnitʼi	mɑɡnɪtʼɪ
მაგნიტიზმი	mɑɡnitʼizmi	mɑɡnɪtʼɪzmɪ
მაგნიუმი	mɑɡniumi	mɑɡnɪumɪ
მაგნოლია	mɑɡnɔliɑ	mɑɡnɔlɪɑ
მადაგასკარი	mɑdɑɡɑskʼɑri	mɑdɑɡɑskʼɑrɪ
მადანი	mɑdɑni	mɑdɑnɪ
მადლი	mɑdli	mɑdlɪ
მავთული	mɑvtʰuli	mɑvtʰulɪ
მავრიკი	mɑvrikʼi	mɑvrɪkʼɪ
მავრიტანია	mɑvritʼɑniɑ	mɑvrɪtʼɑnɪɑ
მაზერი	mɑzɛri	mɑzɛrɪ
მათი	mɑtʰi	mɑtʰɪ
მათრახი	mɑtʰrɑxi	mɑtʰrɑχɪ
მაია	mɑiɑ	mɑɪɑ
მაიკო	mɑikʼɔ	mɑɪkʼɔ
მაიმუნი	mɑimuni	mɑɪmunɪ
მაინც	mɑints	mɑɪnts
მაისი	mɑisi	mɑɪsɪ
მაკედონია	mɑkʼɛdɔniɑ	mɑkʼɛdɔnɪɑ
მალავი	mɑlɑvi	mɑlɑvɪ
მალაიზია	mɑlɑiziɑ	mɑlɑɪzɪɑ
მალი	mɑli	mɑlɪ
მამათმავალი	mɑmɑtʰmɑvɑli	mɑmɑtʰmɑvɑlɪ
მამათმავლი	mɑmɑtʰmɑvli	mɑmɑtʰmɑvlɪ
მამაკაცი	mɑmɑkʼɑtsi	mɑmɑkʼɑtsɪ
მამალი	mɑmɑli	mɑmɑlɪ
მამაცი	mɑmɑtsi	mɑmɑtsɪ
მამიდა	mɑmidɑ	mɑmɪdɑ
მამიკო	mɑmikʼɔ	mɑmɪkʼɔ
მამრი	mɑmri	mɑmrɪ
მამული	mɑmuli	mɑmulɪ
მანგანუმი	mɑnɡɑnumi	mɑnɡɑnumɪ
მანდარინი	mɑndɑrini	mɑndɑrɪnɪ
მანეთი	mɑnɛtʰi	mɑnɛtʰɪ
მანეკენი	mɑnɛkʼɛni	mɑnɛkʼɛnɪ
მანერული	mɑnɛruli	mɑnɛrulɪ
მანიაკალურად	mɑniɑkʼɑlurɑd	mɑnɪɑkʼɑlurɑd
მანძილი	mɑndzili	mɑndzɪlɪ
მაპატიეთ	mɑpʼɑtʼiɛtʰ	mɑpʼɑtʼɪɛtʰ
მარგალიტი	mɑrɡɑlitʼi	mɑrɡɑlɪtʼɪ
მარგანეცი	mɑrɡɑnɛtsi	mɑrɡɑnɛtsɪ
მარგარიტი	mɑrɡɑritʼi	mɑrɡɑrɪtʼɪ
მარგი	mɑrɡi	mɑrɡɪ
მარდალეიშვილი	mɑrdɑlɛiʃvili	mɑrdɑlɛɪʃvɪlɪ
მარდი	mɑrdi	mɑrdɪ
მარეხი	mɑrɛxi	mɑrɛχɪ
მართალი	mɑrtʰɑli	mɑrtʰɑlɪ
მართი	mɑrtʰi	mɑrtʰɪ
მართლმადიდებელი	mɑrtʰlmɑdidɛbɛli	mɑrtʰlmɑdɪdɛbɛlɪ
მართლმადიდებლობა	mɑrtʰlmɑdidɛblɔbɑ	mɑrtʰlmɑdɪdɛblɔbɑ
მარი	mɑri	mɑrɪ
მარიამი	mɑriɑmi	mɑrɪɑmɪ
მარიამობა	mɑriɑmɔbɑ	mɑrɪɑmɔbɑ
მარილი	mɑrili	mɑrɪlɪ
მარილიანი	mɑriliɑni	mɑrɪlɪɑnɪ
მარილიანობა	mɑriliɑnɔbɑ	mɑrɪlɪɑnɔbɑ
მარტვილი	mɑrtʼvili	mɑrtʼvɪlɪ
მარტი	mɑrtʼi	mɑrtʼɪ
მარტივი	mɑrtʼivi	mɑrtʼɪvɪ
მარტოხელა	mɑrtʼɔxɛlɑ	mɑrtʼɔχɛlɑ
მარტყოფი	mɑrtʼqʼɔpʰi	mɑrtʼqʼɔpʰɪ
მარქსიზმი	mɑrkʰsizmi	mɑrkʰsɪzmɪ
მარშრუტი	mɑrʃrutʼi	mɑrʃrutʼɪ
მარჩბივი	mɑrtʃbivi	mɑrtʃbɪvɪ
მარცვალი	mɑrtsvɑli	mɑrtsvɑlɪ
მარცხენა	mɑrtsxɛnɑ	mɑrtsχɛnɑ
მარწყვი	mɑrtsʼqʼvi	mɑrtsʼqʼvɪ
მარხვა	mɑrxvɑ	mɑrχvɑ
მასივი	mɑsivi	mɑsɪvɪ
მასიური	mɑsiuri	mɑsɪurɪ
მასიურობა	mɑsiurɔbɑ	mɑsɪurɔbɑ
მასონი	mɑsɔni	mɑsɔnɪ
მასწავლებელი	mɑstsʼɑvlɛbɛli	mɑstsʼɑvlɛbɛlɪ
მასხარა	mɑsxɑrɑ	mɑsχɑrɑ
მატარებელი	mɑtʼɑrɛbɛli	mɑtʼɑrɛbɛlɪ
მატერიალიზმი	mɑtʼɛriɑlizmi	mɑtʼɛrɪɑlɪzmɪ
მატერიალური	mɑtʼɛriɑluri	mɑtʼɛrɪɑlurɪ
მატიანე	mɑtʼiɑnɛ	mɑtʼɪɑnɛ
მატლი	mɑtʼli	mɑtʼlɪ
მატრიცა	mɑtʼritsɑ	mɑtʼrɪtsɑ
მატყლი	mɑtʼqʼli	mɑtʼqʼlɪ
მაღაზია	mɑɣɑziɑ	mɑʁɑzɪɑ
მაღალი	mɑɣɑli	mɑʁɑlɪ
მაღარიჩი	mɑɣɑritʃi	mɑʁɑrɪtʃɪ
მაღარო	mɑɣɑrɔ	mɑʁɑrɔ
მაღლა	mɑɣlɑ	mɑʁlɑ
მაყუთი	mɑqʼutʰi	mɑqʼutʰɪ
მაჩალიკაშვილი	mɑtʃɑlikʼɑʃvili	mɑtʃɑlɪkʼɑʃvɪlɪ
მაჩვი	mɑtʃvi	mɑtʃvɪ
მაძღარი	mɑdzɣɑri	mɑdzʁɑrɪ
მაწონი	mɑtsʼɔni	mɑtsʼɔnɪ
მაჭარი	mɑtʃʼɑri	mɑtʃʼɑrɪ
მახათი	mɑxɑtʰi	mɑχɑtʰɪ
მახე	mɑxɛ	mɑχɛ
მახვილი	mɑxvili	mɑχvɪlɪ
მახინჯი	mɑxindʒi	mɑχɪndʒɪ
მბრძანებლური	mbrdzɑnɛbluri	mbrdzɑnɛblurɪ
მგალობლიშვილი	mɡɑlɔbliʃvili	mɡɑlɔblɪʃvɪlɪ
მგელი	mɡɛli	mɡɛlɪ
მგზავრი	mɡzɑvri	mɡzɑvrɪ
მგლური	mɡluri	mɡlurɪ
მგონი	mɡɔni	mɡɔnɪ
მგონია	mɡɔniɑ	mɡɔnɪɑ
მგრძნობიარე	mɡrdznɔbiɑrɛ	mɡrdznɔbɪɑrɛ
მდაბალი	mdɑbɑli	mdɑbɑlɪ
მდგომი	mdɡɔmi	mdɡɔmɪ
მდედრი	mdɛdri	mdɛdrɪ
მდედრობითი	mdɛdrɔbitʰi	mdɛdrɔbɪtʰɪ
მდიდარი	mdidɑri	mdɪdɑrɪ
მდივანი	mdivɑni	mdɪvɑnɪ
მდინარე	mdinɑrɛ	mdɪnɑrɛ
მეალილოე	mɛɑlilɔɛ	mɛɑlɪlɔɛ
მეამბოხე	mɛɑmbɔxɛ	mɛɑmbɔχɛ
მეანი	mɛɑni	mɛɑnɪ
მეარღნე	mɛɑrɣnɛ	mɛɑrʁnɛ
მეაფთიაქე	mɛɑpʰtʰiɑkʰɛ	mɛɑpʰtʰɪɑkʰɛ
მებაღე	mɛbɑɣɛ	mɛbɑʁɛ
მეგი	mɛɡi	mɛɡɪ
მეგობარი	mɛɡɔbɑri	mɛɡɔbɑrɪ
მეგრელი	mɛɡrɛli	mɛɡrɛlɪ
მეგრული	mɛɡruli	mɛɡrulɪ
მედეგი	mɛdɛɡi	mɛdɛɡɪ
მედიდური	mɛdiduri	mɛdɪdurɪ
მედიდურობა	mɛdidurɔbɑ	mɛdɪdurɔbɑ
მედიცინა	mɛditsinɑ	mɛdɪtsɪnɑ
მევახშე	mɛvɑxʃɛ	mɛvɑχʃɛ
მევიოლინე	mɛviɔlinɛ	mɛvɪɔlɪnɛ
მეზობელი	mɛzɔbɛli	mɛzɔbɛlɪ
მეზღაპრე	mɛzɣɑpʼrɛ	mɛzʁɑpʼrɛ
მეთოდი	mɛtʰɔdi	mɛtʰɔdɪ
მეთოთხმეტე	mɛtʰɔtʰxmɛtʼɛ	mɛtʰɔtʰχmɛtʼɛ
მეთხუთმეტე	mɛtʰxutʰmɛtʼɛ	mɛtʰχutʰmɛtʼɛ
მეიდანი	mɛidɑni	mɛɪdɑnɪ
მეისრე	mɛisrɛ	mɛɪsrɛ
მელია	mɛliɑ	mɛlɪɑ
მელოდიური	mɛlɔdiuri	mɛlɔdɪurɪ
მელოდიურობა	mɛlɔdiurɔbɑ	mɛlɔdɪurɔbɑ
მემარცხენე	mɛmɑrtsxɛnɛ	mɛmɑrtsχɛnɛ
მემაღაროე	mɛmɑɣɑrɔɛ	mɛmɑʁɑrɔɛ
მემკვიდრე	mɛmkʼvidrɛ	mɛmkʼvɪdrɛ
მენახირე	mɛnɑxirɛ	mɛnɑχɪrɛ
მენახშირე	mɛnɑxʃirɛ	mɛnɑχʃɪrɛ
მენდელევიუმი	mɛndɛlɛviumi	mɛndɛlɛvɪumɪ
მენიუ	mɛniu	mɛnɪu
მენჯი	mɛndʒi	mɛndʒɪ
მეოთხე	mɛɔtʰxɛ	mɛɔtʰχɛ
მეოხებით	mɛɔxɛbitʰ	mɛɔχɛbɪtʰ
მერაბიშვილი	mɛrɑbiʃvili	mɛrɑbɪʃvɪlɪ
მერიდიანი	mɛridiɑni	mɛrɪdɪɑnɪ
მერიქიფე	mɛrikʰipʰɛ	mɛrɪkʰɪpʰɛ
მერცხალი	mɛrtsxɑli	mɛrtsχɑlɪ
მესაიდუმლე	mɛsɑidumlɛ	mɛsɑɪdumlɛ
მესამეული	mɛsɑmɛuli	mɛsɑmɛulɪ
მესაყვირე	mɛsɑqʼvirɛ	mɛsɑqʼvɪrɛ
მესპილენძე	mɛspʼilɛndzɛ	mɛspʼɪlɛndzɛ
მესხეთი	mɛsxɛtʰi	mɛsχɛtʰɪ
მეტალი	mɛtʼɑli	mɛtʼɑlɪ
მეტი	mɛtʼi	mɛtʼɪ
მეტიჩარა	mɛtʼitʃɑrɑ	mɛtʼɪtʃɑrɑ
მეტსახელი	mɛtʼsɑxɛli	mɛtʼsɑχɛlɪ
მეტყველი	mɛtʼqʼvɛli	mɛtʼqʼvɛlɪ
მეუღლე	mɛuɣlɛ	mɛuʁlɛ
მექანიზმი	mɛkʰɑnizmi	mɛkʰɑnɪzmɪ
მექანიკური	mɛkʰɑnikʼuri	mɛkʰɑnɪkʼurɪ
მექსიკა	mɛkʰsikʼɑ	mɛkʰsɪkʼɑ
მეღორე	mɛɣɔrɛ	mɛʁɔrɛ
მეყვავილე	mɛqʼvɑvilɛ	mɛqʼvɑvɪlɛ
მეშვიდე	mɛʃvidɛ	mɛʃvɪdɛ
მეჩეთი	mɛtʃɛtʰi	mɛtʃɛtʰɪ
მეჩვიდმეტე	mɛtʃvidmɛtʼɛ	mɛtʃvɪdmɛtʼɛ
მეცნიერება	mɛtsniɛrɛbɑ	mɛtsnɪɛrɛbɑ
მეცნიერი	mɛtsniɛri	mɛtsnɪɛrɪ
მეცხრე	mɛtsxrɛ	mɛtsχrɛ
მეწამული	mɛtsʼɑmuli	mɛtsʼɑmulɪ
მეწისქვილე	mɛtsʼiskʰvilɛ	mɛtsʼɪskʰvɪlɛ
მეჭეჭი	mɛtʃʼɛtʃʼi	mɛtʃʼɛtʃʼɪ
მეხი	mɛxi	mɛχɪ
მეხოტბე	mɛxɔtʼbɛ	mɛχɔtʼbɛ
მეხუთე	mɛxutʰɛ	mɛχutʰɛ
მზესუმზირა	mzɛsumzirɑ	mzɛsumzɪrɑ
მთაგრეხილი	mtʰɑɡrɛxili	mtʰɑɡrɛχɪlɪ
მთავარანგელოზი	mtʰɑvɑrɑnɡɛlɔzi	mtʰɑvɑrɑnɡɛlɔzɪ
მთავარი	mtʰɑvɑri	mtʰɑvɑrɪ
მთარგმნელი	mtʰɑrɡmnɛli	mtʰɑrɡmnɛlɪ
მთაწმინდა	mtʰɑtsʼmindɑ	mtʰɑtsʼmɪndɑ
მთები	mtʰɛbi	mtʰɛbɪ
მთელი	mtʰɛli	mtʰɛlɪ
მთით	mtʰitʰ	mtʰɪtʰ
მთის	mtʰis	mtʰɪs
მთიულეთი	mtʰiulɛtʰi	mtʰɪulɛtʰɪ
მთლიანად	mtʰliɑnɑd	mtʰlɪɑnɑd
მთლიანი	mtʰliɑni	mtʰlɪɑnɪ
მთლიანობა	mtʰliɑnɔbɑ	mtʰlɪɑnɔbɑ
მიაგნებს	miɑɡnɛbs	mɪɑɡnɛbs
მიამიტი	miɑmitʼi	mɪɑmɪtʼɪ
მიამიტობა	miɑmitʼɔbɑ	mɪɑmɪtʼɔbɑ
მიანმარი	miɑnmɑri	mɪɑnmɑrɪ
მიდის	midis	mɪdɪs
მიველ	mivɛl	mɪvɛl
მიზანი	mizɑni	mɪzɑnɪ
მიზანსცენა	mizɑnstsɛnɑ	mɪzɑnstsɛnɑ
მიზეზი	mizɛzi	mɪzɛzɪ
მიზიდულობა	mizidulɔbɑ	mɪzɪdulɔbɑ
მითამ	mitʰɑm	mɪtʰɑm
მიკროსკოპი	mikʼrɔskʼɔpʼi	mɪkʼrɔskʼɔpʼɪ
მიმატება	mimɑtʼɛbɑ	mɪmɑtʼɛbɑ
მიმზიდველობა	mimzidvɛlɔbɑ	mɪmzɪdvɛlɔbɑ
მიმოზა	mimɔzɑ	mɪmɔzɑ
მიმოხილვით	mimɔxilvitʰ	mɪmɔχɪlvɪtʰ
მინდორი	mindɔri	mɪndɔrɪ
მინიმუმი	minimumi	mɪnɪmumɪ
მინისტრი	ministʼri	mɪnɪstʼrɪ
მირიადი	miriɑdi	mɪrɪɑdɪ
მირონმდინარე	mirɔnmdinɑrɛ	mɪrɔnmdɪnɑrɛ
მირონცხება	mirɔntsxɛbɑ	mɪrɔntsχɛbɑ
მისალმება	misɑlmɛbɑ	mɪsɑlmɛbɑ
მისანი	misɑni	mɪsɑnɪ
მისაწვდომობა	misɑtsʼvdɔmɔbɑ	mɪsɑtsʼvdɔmɔbɑ
მისი	misi	mɪsɪ
მისნობა	misnɔbɑ	mɪsnɔbɑ
მისცემს	mistsɛms	mɪstsɛms
მიტკალი	mitʼkʼɑli	mɪtʼkʼɑlɪ
მიქცევა	mikʰtsɛvɑ	mɪkʰtsɛvɑ
მიყვარხარ	miqʼvɑrxɑr	mɪqʼvɑrχɑr
მიშა	miʃɑ	mɪʃɑ
მიჩიგანი	mitʃiɡɑni	mɪtʃɪɡɑnɪ
მიცემა	mitsɛmɑ	mɪtsɛmɑ
მიცემითი	mitsɛmitʰi	mɪtsɛmɪtʰɪ
მიწა	mitsʼɑ	mɪtsʼɑ
მიწერილობა	mitsʼɛrilɔbɑ	mɪtsʼɛrɪlɔbɑ
მიწისძვრა	mitsʼisdzvrɑ	mɪtsʼɪsdzvrɑ
მიწყივ	mitsʼqʼiv	mɪtsʼqʼɪv
მიხაკი	mixɑkʼi	mɪχɑkʼɪ
მიხეილ	mixɛil	mɪχɛɪl
მიხეილი	mixɛili	mɪχɛɪlɪ
მიხვედრილობა	mixvɛdrilɔbɑ	mɪχvɛdrɪlɔbɑ
მიჯნური	midʒnuri	mɪdʒnurɪ
მიჰყავს	mihqʼɑvs	mɪhqʼɑvs
მკაცრი	mkʼɑtsri	mkʼɑtsrɪ
მკერდი	mkʼɛrdi	mkʼɛrdɪ
მკვდარი	mkʼvdɑri	mkʼvdɑrɪ
მკვეთრი	mkʼvɛtʰri	mkʼvɛtʰrɪ
მკვირცხლი	mkʼvirtsxli	mkʼvɪrtsχlɪ
მკვლელი	mkʼvlɛli	mkʼvlɛlɪ
მკრეხელობა	mkʼrɛxɛlɔbɑ	mkʼrɛχɛlɔbɑ
მლიქვნელობა	mlikʰvnɛlɔbɑ	mlɪkʰvnɛlɔbɑ
მმართველი	mmɑrtʰvɛli	mmɑrtʰvɛlɪ
მმართველობის	mmɑrtʰvɛlɔbis	mmɑrtʰvɛlɔbɪs
მნათობი	mnɑtʰɔbi	mnɑtʰɔbɪ
მობილური	mɔbiluri	mɔbɪlurɪ
მობილურობა	mɔbilurɔbɑ	mɔbɪlurɔbɑ
მოგზაური	mɔɡzɑuri	mɔɡzɑurɪ
მოდერატორი	mɔdɛrɑtʼɔri	mɔdɛrɑtʼɔrɪ
მოდერნიზმი	mɔdɛrnizmi	mɔdɛrnɪzmɪ
მოდიოდა	mɔdiɔdɑ	mɔdɪɔdɑ
მოდის	mɔdis	mɔdɪs
მოდური	mɔduri	mɔdurɪ
მოედანი	mɔɛdɑni	mɔɛdɑnɪ
მოვიდა	mɔvidɑ	mɔvɪdɑ
მოზამბიკი	mɔzɑmbikʼi	mɔzɑmbɪkʼɪ
მოთმინება	mɔtʰminɛbɑ	mɔtʰmɪnɛbɑ
მოთხრობა	mɔtʰxrɔbɑ	mɔtʰχrɔbɑ
მოკავშირე	mɔkʼɑvʃirɛ	mɔkʼɑvʃɪrɛ
მოკვალთული	mɔkʼvɑltʰuli	mɔkʼvɑltʰulɪ
მოკირვა	mɔkʼirvɑ	mɔkʼɪrvɑ
მოკლევადიანი	mɔkʼlɛvɑdiɑni	mɔkʼlɛvɑdɪɑnɪ
მოლოდინი	mɔlɔdini	mɔlɔdɪnɪ
მომლოდინედ	mɔmlɔdinɛd	mɔmlɔdɪnɛd
მომხიბლავი	mɔmxiblɑvi	mɔmχɪblɑvɪ
მონასტერი	mɔnɑstʼɛri	mɔnɑstʼɛrɪ
მონაცემები	mɔnɑtsɛmɛbi	mɔnɑtsɛmɛbɪ
მონოპოლია	mɔnɔpʼɔliɑ	mɔnɔpʼɔlɪɑ
მონოტონური	mɔnɔtʼɔnuri	mɔnɔtʼɔnurɪ
მონტაჟი	mɔntʼɑʒi	mɔntʼɑʒɪ
მონღოლეთი	mɔnɣɔlɛtʰi	mɔnʁɔlɛtʰɪ
მონღოლი	mɔnɣɔli	mɔnʁɔlɪ
მორევი	mɔrɛvi	mɔrɛvɪ
მორიდებულობა	mɔridɛbulɔbɑ	mɔrɪdɛbulɔbɑ
მორიელი	mɔriɛli	mɔrɪɛlɪ
მორჩილობა	mɔrtʃilɔbɑ	mɔrtʃɪlɔbɑ
მორცხვი	mɔrtsxvi	mɔrtsχvɪ
მორცხვობა	mɔrtsxvɔbɑ	mɔrtsχvɔbɑ
მოსამსახურე	mɔsɑmsɑxurɛ	mɔsɑmsɑχurɛ
მოსახლეობა	mɔsɑxlɛɔbɑ	mɔsɑχlɛɔbɑ
მოტეხილობა	mɔtʼɛxilɔbɑ	mɔtʼɛχɪlɔbɑ
მოურიდებლობა	mɔuridɛblɔbɑ	mɔurɪdɛblɔbɑ
მოქმედებითი	mɔkʰmɛdɛbitʰi	mɔkʰmɛdɛbɪtʰɪ
მოქნილად	mɔkʰnilɑd	mɔkʰnɪlɑd
მოქნილი	mɔkʰnili	mɔkʰnɪlɪ
მოქნილობა	mɔkʰnilɔbɑ	mɔkʰnɪlɔbɑ
მოღალატური	mɔɣɑlɑtʼuri	mɔʁɑlɑtʼurɪ
მოშლის	mɔʃlis	mɔʃlɪs
მოციქული	mɔtsikʰuli	mɔtsɪkʰulɪ
მოწითალო	mɔtsʼitʰɑlɔ	mɔtsʼɪtʰɑlɔ
მოწინავე	mɔtsʼinɑvɛ	mɔtsʼɪnɑvɛ
მოწიფულობა	mɔtsʼipʰulɔbɑ	mɔtsʼɪpʰulɔbɑ
მოწონებით	mɔtsʼɔnɛbitʰ	mɔtsʼɔnɛbɪtʰ
მოწყენილობა	mɔtsʼqʼɛnilɔbɑ	mɔtsʼqʼɛnɪlɔbɑ
მოხელე	mɔxɛlɛ	mɔχɛlɛ
მოხერხებული	mɔxɛrxɛbuli	mɔχɛrχɛbulɪ
მოხრილობა	mɔxrilɔbɑ	mɔχrɪlɔbɑ
მოხუცებულობა	mɔxutsɛbulɔbɑ	mɔχutsɛbulɔbɑ
მოხუცი	mɔxutsi	mɔχutsɪ
მრავალი	mrɑvɑli	mrɑvɑlɪ
მრავლობითი	mrɑvlɔbitʰi	mrɑvlɔbɪtʰɪ
მრგვალი	mrɡvɑli	mrɡvɑlɪ
მრეწველი	mrɛtsʼvɛli	mrɛtsʼvɛlɪ
მრუში	mruʃi	mruʃɪ
მსახური	msɑxuri	msɑχurɪ
მსოფლიო	msɔpʰliɔ	msɔpʰlɪɔ
მსუბუქი	msubukʰi	msubukʰɪ
მსუქანი	msukʰɑni	msukʰɑnɪ
მსხალი	msxɑli	msχɑlɪ
მსხვილი	msxvili	msχvɪlɪ
მტერი	mtʼɛri	mtʼɛrɪ
მტვერი	mtʼvɛri	mtʼvɛrɪ
მტვერსასრუტი	mtʼvɛrsɑsrutʼi	mtʼvɛrsɑsrutʼɪ
მტვრიანა	mtʼvriɑnɑ	mtʼvrɪɑnɑ
მტკაველი	mtʼkʼɑvɛli	mtʼkʼɑvɛlɪ
მტკვარი	mtʼkʼvɑri	mtʼkʼvɑrɪ
მტკივნეულად	mtʼkʼivnɛulɑd	mtʼkʼɪvnɛulɑd
მტკივნეული	mtʼkʼivnɛuli	mtʼkʼɪvnɛulɪ
მტკივნეულობა	mtʼkʼivnɛulɔbɑ	mtʼkʼɪvnɛulɔbɑ
მტკიცე	mtʼkʼitsɛ	mtʼkʼɪtsɛ
მტკიცედ	mtʼkʼitsɛd	mtʼkʼɪtsɛd
მტრედი	mtʼrɛdi	mtʼrɛdɪ
მტრული	mtʼruli	mtʼrulɪ
მუგუზალი	muɡuzɑli	muɡuzɑlɪ
მუდმივი	mudmivi	mudmɪvɪ
მუდმივობა	mudmivɔbɑ	mudmɪvɔbɑ
მული	muli	mulɪ
მუნჯი	mundʒi	mundʒɪ
მუსიკა	musikʼɑ	musɪkʼɑ
მუსულმანი	musulmɑni	musulmɑnɪ
მუქი	mukʰi	mukʰɪ
მუყაითად	muqʼɑitʰɑd	muqʼɑɪtʰɑd
მუყაითი	muqʼɑitʰi	muqʼɑɪtʰɪ
მუყაითობა	muqʼɑitʰɔbɑ	muqʼɑɪtʰɔbɑ
მუშაკი	muʃɑkʼi	muʃɑkʼɪ
მუშკეტი	muʃkʼɛtʼi	muʃkʼɛtʼɪ
მუშტარი	muʃtʼɑri	muʃtʼɑrɪ
მუშტი	muʃtʼi	muʃtʼɪ
მუცელი	mutsɛli	mutsɛlɪ
მუჭი	mutʃʼi	mutʃʼɪ
მუხა	muxɑ	muχɑ
მუხლი	muxli	muχlɪ
მუხრუჭი	muxrutʃʼi	muχrutʃʼɪ
მუხუდო	muxudɔ	muχudɔ
მუჰაჯირობა	muhɑdʒirɔbɑ	muhɑdʒɪrɔbɑ
მფრინველი	mpʰrinvɛli	mpʰrɪnvɛlɪ
მღვდელი	mɣvdɛli	mʁvdɛlɪ
მღვდლობა	mɣvdlɔbɑ	mʁvdlɔbɑ
მყარი	mqʼɑri	mqʼɑrɪ
მყვირალა	mqʼvirɑlɑ	mqʼvɪrɑlɑ
მყრალი	mqʼrɑli	mqʼrɑlɪ
მშვენიერი	mʃvɛniɛri	mʃvɛnɪɛrɪ
მშვიდი	mʃvidi	mʃvɪdɪ
მშვიდობა	mʃvidɔbɑ	mʃvɪdɔbɑ
მშვიდობით	mʃvidɔbitʰ	mʃvɪdɔbɪtʰ
მშვილდი	mʃvildi	mʃvɪldɪ
მშიერი	mʃiɛri	mʃɪɛrɪ
მშიშარა	mʃiʃɑrɑ	mʃɪʃɑrɑ
მშობელი	mʃɔbɛli	mʃɔbɛlɪ
მშრალი	mʃrɑli	mʃrɑlɪ
მცდარი	mtsdɑri	mtsdɑrɪ
მცენარეული	mtsɛnɑrɛuli	mtsɛnɑrɛulɪ
მცირე	mtsirɛ	mtsɪrɛ
მცხეთა	mtsxɛtʰɑ	mtsχɛtʰɑ
მძაფრი	mdzɑpʰri	mdzɑpʰrɪ
მძიმე	mdzimɛ	mdzɪmɛ
მწერი	mtsʼɛri	mtsʼɛrɪ
მწვადი	mtsʼvɑdi	mtsʼvɑdɪ
მწვრთნელი	mtsʼvrtʰnɛli	mtsʼvrtʰnɛlɪ
მწირი	mtsʼiri	mtsʼɪrɪ
მწუხრი	mtsʼuxri	mtsʼuχrɪ
მჭადი	mtʃʼɑdi	mtʃʼɑdɪ
მჭედელი	mtʃʼɛdɛli	mtʃʼɛdɛlɪ
მჭედლიშვილი	mtʃʼɛdliʃvili	mtʃʼɛdlɪʃvɪlɪ
მჭიდრო	mtʃʼidrɔ	mtʃʼɪdrɔ
მხარე	mxɑrɛ	mχɑrɛ
მხარი	mxɑri	mχɑrɪ
მხატვრული	mxɑtʼvruli	mχɑtʼvrulɪ
მხდალი	mxdɑli	mχdɑlɪ
მხედარი	mxɛdɑri	mχɛdɑrɪ
მხედრული	mxɛdruli	mχɛdrulɪ
მხეცი	mxɛtsi	mχɛtsɪ
მხეცობა	mxɛtsɔbɑ	mχɛtsɔbɑ
მხიარული	mxiɑruli	mχɪɑrulɪ
მხოლობითი	mxɔlɔbitʰi	mχɔlɔbɪtʰɪ
მხოლოდ	mxɔlɔd	mχɔlɔd
მხოლოდშობილი	mxɔlɔdʃɔbili	mχɔlɔdʃɔbɪlɪ
მხოლოობითი	mxɔlɔɔbitʰi	mχɔlɔɔbɪtʰɪ
ნაადრევი	nɑɑdrɛvi	nɑɑdrɛvɪ
ნაბიჯი	nɑbidʒi	nɑbɪdʒɪ
ნაგაზი	nɑɡɑzi	nɑɡɑzɪ
ნაგულისხმევი	nɑɡulisxmɛvi	nɑɡulɪsχmɛvɪ
ნადირი	nɑdiri	nɑdɪrɪ
ნადირობა	nɑdirɔbɑ	nɑdɪrɔbɑ
ნავარდი	nɑvɑrdi	nɑvɑrdɪ
ნათელი	nɑtʰɛli	nɑtʰɛlɪ
ნათესაობითი	nɑtʰɛsɑɔbitʰi	nɑtʰɛsɑɔbɪtʰɪ
ნათია	nɑtʰiɑ	nɑtʰɪɑ
ნათლია	nɑtʰliɑ	nɑtʰlɪɑ
ნათლიდედა	nɑtʰlidɛdɑ	nɑtʰlɪdɛdɑ
ნათლიმამა	nɑtʰlimɑmɑ	nɑtʰlɪmɑmɑ
ნათლისღება	nɑtʰlisɣɛbɑ	nɑtʰlɪsʁɛbɑ
ნაიარევი	nɑiɑrɛvi	nɑɪɑrɛvɪ
ნაკადი	nɑkʼɑdi	nɑkʼɑdɪ
ნაკადული	nɑkʼɑduli	nɑkʼɑdulɪ
ნაკერი	nɑkʼɛri	nɑkʼɛrɪ
ნაკვერცხალი	nɑkʼvɛrtsxɑli	nɑkʼvɛrtsχɑlɪ
ნაკვთი	nɑkʼvtʰi	nɑkʼvtʰɪ
ნაკლები	nɑkʼlɛbi	nɑkʼlɛbɪ
ნაკლი	nɑkʼli	nɑkʼlɪ
ნამგალი	nɑmɡɑli	nɑmɡɑlɪ
ნამდვილად	nɑmdvilɑd	nɑmdvɪlɑd
ნამდვილი	nɑmdvili	nɑmdvɪlɪ
ნამდვილობა	nɑmdvilɔbɑ	nɑmdvɪlɔbɑ
ნამიბია	nɑmibiɑ	nɑmɪbɪɑ
ნამიოკობანა	nɑmiɔkʼɔbɑnɑ	nɑmɪɔkʼɔbɑnɑ
ნაპირი	nɑpʼiri	nɑpʼɪrɪ
ნარგიზი	nɑrɡizi	nɑrɡɪzɪ
ნარდი	nɑrdi	nɑrdɪ
ნართანიანი	nɑrtʰɑniɑni	nɑrtʰɑnɪɑnɪ
ნარინჯისფერი	nɑrindʒispʰɛri	nɑrɪndʒɪspʰɛrɪ
ნარიყალა	nɑriqʼɑlɑ	nɑrɪqʼɑlɑ
ნარკოტიკი	nɑrkʼɔtʼikʼi	nɑrkʼɔtʼɪkʼɪ
ნასვამი	nɑsvɑmi	nɑsvɑmɪ
ნატეხი	nɑtʼɛxi	nɑtʼɛχɪ
ნატრიუმი	nɑtʼriumi	nɑtʼrɪumɪ
ნაფეხური	nɑpʰɛxuri	nɑpʰɛχurɪ
ნაღველა	nɑɣvɛlɑ	nɑʁvɛlɑ
ნაღმი	nɑɣmi	nɑʁmɪ
ნაყინი	nɑqʼini	nɑqʼɪnɪ
ნაყოფი	nɑqʼɔpʰi	nɑqʼɔpʰɪ
ნაყოფიერება	nɑqʼɔpʰiɛrɛbɑ	nɑqʼɔpʰɪɛrɛbɑ
ნაყოფიერი	nɑqʼɔpʰiɛri	nɑqʼɔpʰɪɛrɪ
ნაშიერი	nɑʃiɛri	nɑʃɪɛrɪ
ნაცვალსახელი	nɑtsvɑlsɑxɛli	nɑtsvɑlsɑχɛlɪ
ნაციონალი	nɑtsiɔnɑli	nɑtsɪɔnɑlɪ
ნაცნობი	nɑtsnɔbi	nɑtsnɔbɪ
ნაცრისფერი	nɑtsrispʰɛri	nɑtsrɪspʰɛrɪ
ნაძვი	nɑdzvi	nɑdzvɪ
ნაწილი	nɑtsʼili	nɑtsʼɪlɪ
ნაწლავი	nɑtsʼlɑvi	nɑtsʼlɑvɪ
ნაჭრილობევი	nɑtʃʼrilɔbɛvi	nɑtʃʼrɪlɔbɛvɪ
ნახავს	nɑxɑvs	nɑχɑvs
ნახატი	nɑxɑtʼi	nɑχɑtʼɪ
ნახევარდა	nɑxɛvɑrdɑ	nɑχɛvɑrdɑ
ნახევარი	nɑxɛvɑri	nɑχɛvɑrɪ
ნახევარკუნძული	nɑxɛvɑrkʼundzuli	nɑχɛvɑrkʼundzulɪ
ნახევრად	nɑxɛvrɑd	nɑχɛvrɑd
ნახვამდის	nɑxvɑmdis	nɑχvɑmdɪs
ნახირი	nɑxiri	nɑχɪrɪ
ნახტომი	nɑxtʼɔmi	nɑχtʼɔmɪ
ნახშირბადი	nɑxʃirbɑdi	nɑχʃɪrbɑdɪ
ნახშირი	nɑxʃiri	nɑχʃɪrɪ
ნახშირორჟანგი	nɑxʃirɔrʒɑnɡi	nɑχʃɪrɔrʒɑnɡɪ
ნაჯახი	nɑdʒɑxi	nɑdʒɑχɪ
ნდობით	ndɔbitʰ	ndɔbɪtʰ
ნებიერი	nɛbiɛri	nɛbɪɛrɪ
ნებისმიერი	nɛbismiɛri	nɛbɪsmɪɛrɪ
ნედლი	nɛdli	nɛdlɪ
ნევროზი	nɛvrɔzi	nɛvrɔzɪ
ნეილონი	nɛilɔni	nɛɪlɔnɪ
ნეიტრალიტეტი	nɛitʼrɑlitʼɛtʼi	nɛɪtʼrɑlɪtʼɛtʼɪ
ნეკნები	nɛkʼnɛbi	nɛkʼnɛbɪ
ნელი	nɛli	nɛlɪ
ნემსი	nɛmsi	nɛmsɪ
ნეოდიმიუმი	nɛɔdimiumi	nɛɔdɪmɪumɪ
ნეონი	nɛɔni	nɛɔnɪ
ნეპალი	nɛpʼɑli	nɛpʼɑlɪ
ნეპტუნიუმი	nɛpʼtʼuniumi	nɛpʼtʼunɪumɪ
ნერვი	nɛrvi	nɛrvɪ
ნერვიულად	nɛrviulɑd	nɛrvɪulɑd
ნერვიული	nɛrviuli	nɛrvɪulɪ
ნერვიულობა	nɛrviulɔbɑ	nɛrvɪulɔbɑ
ნერვული	nɛrvuli	nɛrvulɪ
ნეტავი	nɛtʼɑvi	nɛtʼɑvɪ
ნიადაგ	niɑdɑɡ	nɪɑdɑɡ
ნიადაგი	niɑdɑɡi	nɪɑdɑɡɪ
ნიანგი	niɑnɡi	nɪɑnɡɪ
ნიაღვარი	niɑɣvɑri	nɪɑʁvɑrɪ
ნიგერი	niɡɛri	nɪɡɛrɪ
ნიგერია	niɡɛriɑ	nɪɡɛrɪɑ
ნიგოზი	niɡɔzi	nɪɡɔzɪ
ნიდერლანდი	nidɛrlɑndi	nɪdɛrlɑndɪ
ნივთიერება	nivtʰiɛrɛbɑ	nɪvtʰɪɛrɛbɑ
ნიკაპი	nikʼɑpʼi	nɪkʼɑpʼɪ
ნიკარაგუა	nikʼɑrɑɡuɑ	nɪkʼɑrɑɡuɑ
ნიკელი	nikʼɛli	nɪkʼɛlɪ
ნიკოლოზ	nikʼɔlɔz	nɪkʼɔlɔz
ნიკოტინი	nikʼɔtʼini	nɪkʼɔtʼɪnɪ
ნიკოფსია	nikʼɔpʰsiɑ	nɪkʼɔpʰsɪɑ
ნიობიუმი	niɔbiumi	nɪɔbɪumɪ
ნისია	nisiɑ	nɪsɪɑ
ნისკარტი	niskʼɑrtʼi	nɪskʼɑrtʼɪ
ნისლი	nisli	nɪslɪ
ნისლიანი	nisliɑni	nɪslɪɑnɪ
ნიღაბი	niɣɑbi	nɪʁɑbɪ
ნიშა	niʃɑ	nɪʃɑ
ნიშანი	niʃɑni	nɪʃɑnɪ
ნიჭი	nitʃʼi	nɪtʃʼɪ
ნიჭიერი	nitʃʼiɛri	nɪtʃʼɪɛrɪ
ნობელიუმი	nɔbɛliumi	nɔbɛlɪumɪ
ნოემბერი	nɔɛmbɛri	nɔɛmbɛrɪ
ნომერი	nɔmɛri	nɔmɛrɪ
ნორვეგია	nɔrvɛɡiɑ	nɔrvɛɡɪɑ
ნორმალური	nɔrmɑluri	nɔrmɑlurɪ
ნორჩი	nɔrtʃi	nɔrtʃɪ
ნუგეში	nuɡɛʃi	nuɡɛʃɪ
ნული	nuli	nulɪ
ნუში	nuʃi	nuʃɪ
ობი	ɔbi	ɔbɪ
ობიექტური	ɔbiɛkʰtʼuri	ɔbɪɛkʰtʼurɪ
ობიექტურობა	ɔbiɛkʰtʼurɔbɑ	ɔbɪɛkʰtʼurɔbɑ
ობოლი	ɔbɔli	ɔbɔlɪ
ოდიოზური	ɔdiɔzuri	ɔdɪɔzurɪ
ოზურგეთი	ɔzurɡɛtʰi	ɔzurɡɛtʰɪ
ოთხი	ɔtʰxi	ɔtʰχɪ
ოთხმაგი	ɔtʰxmɑɡi	ɔtʰχmɑɡɪ
ოთხმოცდაათი	ɔtʰxmɔtsdɑɑtʰi	ɔtʰχmɔtsdɑɑtʰɪ
ოთხმოცდაერთი	ɔtʰxmɔtsdɑɛrtʰi	ɔtʰχmɔtsdɑɛrtʰɪ
ოთხმოცდაექვსი	ɔtʰxmɔtsdɑɛkʰvsi	ɔtʰχmɔtsdɑɛkʰvsɪ
ოთხმოცდათერთმეტი	ɔtʰxmɔtsdɑtʰɛrtʰmɛtʼi	ɔtʰχmɔtsdɑtʰɛrtʰmɛtʼɪ
ოთხმოცდათექვსმეტი	ɔtʰxmɔtsdɑtʰɛkʰvsmɛtʼi	ɔtʰχmɔtsdɑtʰɛkʰvsmɛtʼɪ
ოთხმოცდათვრამეტი	ɔtʰxmɔtsdɑtʰvrɑmɛtʼi	ɔtʰχmɔtsdɑtʰvrɑmɛtʼɪ
ოთხმოცდათოთხმეტი	ɔtʰxmɔtsdɑtʰɔtʰxmɛtʼi	ɔtʰχmɔtsdɑtʰɔtʰχmɛtʼɪ
ოთხმოცდათორმეტი	ɔtʰxmɔtsdɑtʰɔrmɛtʼi	ɔtʰχmɔtsdɑtʰɔrmɛtʼɪ
ოთხმოცდათხუთმეტი	ɔtʰxmɔtsdɑtʰxutʰmɛtʼi	ɔtʰχmɔtsdɑtʰχutʰmɛtʼɪ
ოთხმოცდაოთხი	ɔtʰxmɔtsdɑɔtʰxi	ɔtʰχmɔtsdɑɔtʰχɪ
ოთხმოცდაორი	ɔtʰxmɔtsdɑɔri	ɔtʰχmɔtsdɑɔrɪ
ოთხმოცდარვა	ɔtʰxmɔtsdɑrvɑ	ɔtʰχmɔtsdɑrvɑ
ოთხმოცდასამი	ɔtʰxmɔtsdɑsɑmi	ɔtʰχmɔtsdɑsɑmɪ
ოთხმოცდაშვიდი	ɔtʰxmɔtsdɑʃvidi	ɔtʰχmɔtsdɑʃvɪdɪ
ოთხმოცდაჩვიდმეტი	ɔtʰxmɔtsdɑtʃvidmɛtʼi	ɔtʰχmɔtsdɑtʃvɪdmɛtʼɪ
ოთხმოცდაცამეტი	ɔtʰxmɔtsdɑtsɑmɛtʼi	ɔtʰχmɔtsdɑtsɑmɛtʼɪ
ოთხმოცდაცხრა	ɔtʰxmɔtsdɑtsxrɑ	ɔtʰχmɔtsdɑtsχrɑ
ოთხმოცდაცხრამეტი	ɔtʰxmɔtsdɑtsxrɑmɛtʼi	ɔtʰχmɔtsdɑtsχrɑmɛtʼɪ
ოთხმოცდახუთი	ɔtʰxmɔtsdɑxutʰi	ɔtʰχmɔtsdɑχutʰɪ
ოთხმოცი	ɔtʰxmɔtsi	ɔtʰχmɔtsɪ
ოთხშაბათი	ɔtʰxʃɑbɑtʰi	ɔtʰχʃɑbɑtʰɪ
ოკრუგი	ɔkʼruɡi	ɔkʼruɡɪ
ოკუპაცია	ɔkʼupʼɑtsiɑ	ɔkʼupʼɑtsɪɑ
ოკუპირებული	ɔkʼupʼirɛbuli	ɔkʼupʼɪrɛbulɪ
ოლიგარქია	ɔliɡɑrkʰiɑ	ɔlɪɡɑrkʰɪɑ
ოლქი	ɔlkʰi	ɔlkʰɪ
ომანი	ɔmɑni	ɔmɑnɪ
ომი	ɔmi	ɔmɪ
ოპერატორი	ɔpʼɛrɑtʼɔri	ɔpʼɛrɑtʼɔrɪ
ოპონენტი	ɔpʼɔnɛntʼi	ɔpʼɔnɛntʼɪ
ორაგული	ɔrɑɡuli	ɔrɑɡulɪ
ორაზროვანი	ɔrɑzrɔvɑni	ɔrɑzrɔvɑnɪ
ორბიტა	ɔrbitʼɑ	ɔrbɪtʼɑ
ორგაზმი	ɔrɡɑzmi	ɔrɡɑzmɪ
ორგანი	ɔrɡɑni	ɔrɡɑnɪ
ორგანული	ɔrɡɑnuli	ɔrɡɑnulɪ
ორგული	ɔrɡuli	ɔrɡulɪ
ორეული	ɔrɛuli	ɔrɛulɪ
ორთქლი	ɔrtʰkʰli	ɔrtʰkʰlɪ
ორი	ɔri	ɔrɪ
ორიგინალი	ɔriɡinɑli	ɔrɪɡɪnɑlɪ
ორიგინალობა	ɔriɡinɑlɔbɑ	ɔrɪɡɪnɑlɔbɑ
ორივე	ɔrivɛ	ɔrɪvɛ
ორმაგი	ɔrmɑɡi	ɔrmɑɡɪ
ორმოცდაათი	ɔrmɔtsdɑɑtʰi	ɔrmɔtsdɑɑtʰɪ
ორმოცდაერთი	ɔrmɔtsdɑɛrtʰi	ɔrmɔtsdɑɛrtʰɪ
ორმოცდაექვსი	ɔrmɔtsdɑɛkʰvsi	ɔrmɔtsdɑɛkʰvsɪ
ორმოცდათერთმეტი	ɔrmɔtsdɑtʰɛrtʰmɛtʼi	ɔrmɔtsdɑtʰɛrtʰmɛtʼɪ
ორმოცდათექვსმეტი	ɔrmɔtsdɑtʰɛkʰvsmɛtʼi	ɔrmɔtsdɑtʰɛkʰvsmɛtʼɪ
ორმოცდათვრამეტი	ɔrmɔtsdɑtʰvrɑmɛtʼi	ɔrmɔtsdɑtʰvrɑmɛtʼɪ
ორმოცდათოთხმეტი	ɔrmɔtsdɑtʰɔtʰxmɛtʼi	ɔrmɔtsdɑtʰɔtʰχmɛtʼɪ
ორმოცდათორმეტი	ɔrmɔtsdɑtʰɔrmɛtʼi	ɔrmɔtsdɑtʰɔrmɛtʼɪ
ორმოცდათხუთმეტი	ɔrmɔtsdɑtʰxutʰmɛtʼi	ɔrmɔtsdɑtʰχutʰmɛtʼɪ
ორმოცდაოთხი	ɔrmɔtsdɑɔtʰxi	ɔrmɔtsdɑɔtʰχɪ
ორმოცდაორი	ɔrmɔtsdɑɔri	ɔrmɔtsdɑɔrɪ
ორმოცდასამი	ɔrmɔtsdɑsɑmi	ɔrmɔtsdɑsɑmɪ
ორმოცდაშვიდი	ɔrmɔtsdɑʃvidi	ɔrmɔtsdɑʃvɪdɪ
ორმოცდაჩვიდმეტი	ɔrmɔtsdɑtʃvidmɛtʼi	ɔrmɔtsdɑtʃvɪdmɛtʼɪ
ორმოცდაცამეტი	ɔrmɔtsdɑtsɑmɛtʼi	ɔrmɔtsdɑtsɑmɛtʼɪ
ორმოცდაცხრა	ɔrmɔtsdɑtsxrɑ	ɔrmɔtsdɑtsχrɑ
ორმოცდაცხრამეტი	ɔrmɔtsdɑtsxrɑmɛtʼi	ɔrmɔtsdɑtsχrɑmɛtʼɪ
ორმოცდახუთი	ɔrmɔtsdɑxutʰi	ɔrmɔtsdɑχutʰɪ
ორმოცი	ɔrmɔtsi	ɔrmɔtsɪ
ორობითი	ɔrɔbitʰi	ɔrɔbɪtʰɪ
ოროლი	ɔrɔli	ɔrɔlɪ
ორპირი	ɔrpʼiri	ɔrpʼɪrɪ
ორპირობა	ɔrpʼirɔbɑ	ɔrpʼɪrɔbɑ
ორსული	ɔrsuli	ɔrsulɪ
ორშაბათი	ɔrʃɑbɑtʰi	ɔrʃɑbɑtʰɪ
ოსეთი	ɔsɛtʰi	ɔsɛtʰɪ
ოსი	ɔsi	ɔsɪ
ოსმიუმი	ɔsmiumi	ɔsmɪumɪ
ოსპი	ɔspʼi	ɔspʼɪ
ოსტატი	ɔstʼɑtʼi	ɔstʼɑtʼɪ
ოსური	ɔsuri	ɔsurɪ
ოფი	ɔpʰi	ɔpʰɪ
ოფიციალური	ɔpʰitsiɑluri	ɔpʰɪtsɪɑlurɪ
ოფლი	ɔpʰli	ɔpʰlɪ
ოფოფი	ɔpʰɔpʰi	ɔpʰɔpʰɪ
ოქტომბერი	ɔkʰtʼɔmbɛri	ɔkʰtʼɔmbɛrɪ
ოღონდ	ɔɣɔnd	ɔʁɔnd
ოჩამჩირე	ɔtʃɑmtʃirɛ	ɔtʃɑmtʃɪrɛ
ოცდაათი	ɔtsdɑɑtʰi	ɔtsdɑɑtʰɪ
ოცდაერთი	ɔtsdɑɛrtʰi	ɔtsdɑɛrtʰɪ
ოცდაექვსი	ɔtsdɑɛkʰvsi	ɔtsdɑɛkʰvsɪ
ოცდათერთმეტი	ɔtsdɑtʰɛrtʰmɛtʼi	ɔtsdɑtʰɛrtʰmɛtʼɪ
ოცდათექვსმეტი	ɔtsdɑtʰɛkʰvsmɛtʼi	ɔtsdɑtʰɛkʰvsmɛtʼɪ
ოცდათვრამეტი	ɔtsdɑtʰvrɑmɛtʼi	ɔtsdɑtʰvrɑmɛtʼɪ
ოცდათოთხმეტი	ɔtsdɑtʰɔtʰxmɛtʼi	ɔtsdɑtʰɔtʰχmɛtʼɪ
ოცდათორმეტი	ɔtsdɑtʰɔrmɛtʼi	ɔtsdɑtʰɔrmɛtʼɪ
ოცდათხუთმეტი	ɔtsdɑtʰxutʰmɛtʼi	ɔtsdɑtʰχutʰmɛtʼɪ
ოცდაოთხი	ɔtsdɑɔtʰxi	ɔtsdɑɔtʰχɪ
ოცდაორი	ɔtsdɑɔri	ɔtsdɑɔrɪ
ოცდასამი	ɔtsdɑsɑmi	ɔtsdɑsɑmɪ
ოცდაშვიდი	ɔtsdɑʃvidi	ɔtsdɑʃvɪdɪ
ოცდაჩვიდმეტი	ɔtsdɑtʃvidmɛtʼi	ɔtsdɑtʃvɪdmɛtʼɪ
ოცდაცამეტი	ɔtsdɑtsɑmɛtʼi	ɔtsdɑtsɑmɛtʼɪ
ოცდაცხრა	ɔtsdɑtsxrɑ	ɔtsdɑtsχrɑ
ოცდაცხრამეტი	ɔtsdɑtsxrɑmɛtʼi	ɔtsdɑtsχrɑmɛtʼɪ
ოცდახუთი	ɔtsdɑxutʰi	ɔtsdɑχutʰɪ
ოცი	ɔtsi	ɔtsɪ
ოჯახი	ɔdʒɑxi	ɔdʒɑχɪ
პაემანები	pʼɑɛmɑnɛbi	pʼɑɛmɑnɛbɪ
პაემანებით	pʼɑɛmɑnɛbitʰ	pʼɑɛmɑnɛbɪtʰ
პაემანების	pʼɑɛmɑnɛbis	pʼɑɛmɑnɛbɪs
პაემანით	pʼɑɛmɑnitʰ	pʼɑɛmɑnɪtʰ
პაემანის	pʼɑɛmɑnis	pʼɑɛmɑnɪs
პაემანნი	pʼɑɛmɑnni	pʼɑɛmɑnnɪ
პავლიაშვილი	pʼɑvliɑʃvili	pʼɑvlɪɑʃvɪlɪ
პათოლოგიური	pʼɑtʰɔlɔɡiuri	pʼɑtʰɔlɔɡɪurɪ
პაიკი	pʼɑikʼi	pʼɑɪkʼɪ
პაკეტი	pʼɑkʼɛtʼi	pʼɑkʼɛtʼɪ
პაკისტანი	pʼɑkʼistʼɑni	pʼɑkʼɪstʼɑnɪ
პალადიუმი	pʼɑlɑdiumi	pʼɑlɑdɪumɪ
პალანი	pʼɑlɑni	pʼɑlɑnɪ
პალესტინა	pʼɑlɛstʼinɑ	pʼɑlɛstʼɪnɑ
პანაშვიდი	pʼɑnɑʃvidi	pʼɑnɑʃvɪdɪ
პანკრეასი	pʼɑnkʼrɛɑsi	pʼɑnkʼrɛɑsɪ
პანღური	pʼɑnɣuri	pʼɑnʁurɪ
პანჩური	pʼɑntʃuri	pʼɑntʃurɪ
პაპი	pʼɑpʼi	pʼɑpʼɪ
პაპუნაშვილი	pʼɑpʼunɑʃvili	pʼɑpʼunɑʃvɪlɪ
პარაგვაი	pʼɑrɑɡvɑi	pʼɑrɑɡvɑɪ
პარალელური	pʼɑrɑlɛluri	pʼɑrɑlɛlurɪ
პარასკევი	pʼɑrɑskʼɛvi	pʼɑrɑskʼɛvɪ
პარი	pʼɑri	pʼɑrɪ
პარიზი	pʼɑrizi	pʼɑrɪzɪ
პარიკმახერი	pʼɑrikʼmɑxɛri	pʼɑrɪkʼmɑχɛrɪ
პარტნიორი	pʼɑrtʼniɔri	pʼɑrtʼnɪɔrɪ
პარტნიორობა	pʼɑrtʼniɔrɔbɑ	pʼɑrtʼnɪɔrɔbɑ
პასიური	pʼɑsiuri	pʼɑsɪurɪ
პასიურობა	pʼɑsiurɔbɑ	pʼɑsɪurɔbɑ
პასპორტი	pʼɑspʼɔrtʼi	pʼɑspʼɔrtʼɪ
პასუხი	pʼɑsuxi	pʼɑsuχɪ
პასუხის	pʼɑsuxis	pʼɑsuχɪs
პასუხისმგებელი	pʼɑsuxismɡɛbɛli	pʼɑsuχɪsmɡɛbɛlɪ
პასუხისმგებლობა	pʼɑsuxismɡɛblɔbɑ	pʼɑsuχɪsmɡɛblɔbɑ
პასუხობს	pʼɑsuxɔbs	pʼɑsuχɔbs
პატარძალი	pʼɑtʼɑrdzɑli	pʼɑtʼɑrdzɑlɪ
პატივი	pʼɑtʼivi	pʼɑtʼɪvɪ
პატიოსანი	pʼɑtʼiɔsɑni	pʼɑtʼɪɔsɑnɪ
პატრიარქი	pʼɑtʼriɑrkʰi	pʼɑtʼrɪɑrkʰɪ
პატრიარქობა	pʼɑtʼriɑrkʰɔbɑ	pʼɑtʼrɪɑrkʰɔbɑ
პატრონი	pʼɑtʼrɔni	pʼɑtʼrɔnɪ
პატრუქი	pʼɑtʼrukʰi	pʼɑtʼrukʰɪ
პაწია	pʼɑtsʼiɑ	pʼɑtsʼɪɑ
პედაგოგიური	pʼɛdɑɡɔɡiuri	pʼɛdɑɡɔɡɪurɪ
პედანტური	pʼɛdɑntʼuri	pʼɛdɑntʼurɪ
პედიატრი	pʼɛdiɑtʼri	pʼɛdɪɑtʼrɪ
პედიატრია	pʼɛdiɑtʼriɑ	pʼɛdɪɑtʼrɪɑ
პეკინი	pʼɛkʼini	pʼɛkʼɪnɪ
პენისი	pʼɛnisi	pʼɛnɪsɪ
პენსია	pʼɛnsiɑ	pʼɛnsɪɑ
პენსილვანია	pʼɛnsilvɑniɑ	pʼɛnsɪlvɑnɪɑ
პერანგი	pʼɛrɑnɡi	pʼɛrɑnɡɪ
პერანგის	pʼɛrɑnɡis	pʼɛrɑnɡɪs
პერგამენტი	pʼɛrɡɑmɛntʼi	pʼɛrɡɑmɛntʼɪ
პერიოდული	pʼɛriɔduli	pʼɛrɪɔdulɪ
პიანინო	pʼiɑninɔ	pʼɪɑnɪnɔ
პიგმეი	pʼiɡmɛi	pʼɪɡmɛɪ
პიდარასტი	pʼidɑrɑstʼi	pʼɪdɑrɑstʼɪ
პიკანტური	pʼikʼɑntʼuri	pʼɪkʼɑntʼurɪ
პიკანტურობა	pʼikʼɑntʼurɔbɑ	pʼɪkʼɑntʼurɔbɑ
პილიგრიმი	pʼiliɡrimi	pʼɪlɪɡrɪmɪ
პილიგრიმობა	pʼiliɡrimɔbɑ	pʼɪlɪɡrɪmɔbɑ
პილპილი	pʼilpʼili	pʼɪlpʼɪlɪ
პირადად	pʼirɑdɑd	pʼɪrɑdɑd
პირადი	pʼirɑdi	pʼɪrɑdɪ
პირამიდა	pʼirɑmidɑ	pʼɪrɑmɪdɑ
პირგასამტეხლო	pʼirɡɑsɑmtʼɛxlɔ	pʼɪrɡɑsɑmtʼɛχlɔ
პირდაპირი	pʼirdɑpʼiri	pʼɪrdɑpʼɪrɪ
პირდაპირობა	pʼirdɑpʼirɔbɑ	pʼɪrdɑpʼɪrɔbɑ
პირველადი	pʼirvɛlɑdi	pʼɪrvɛlɑdɪ
პირველი	pʼirvɛli	pʼɪrvɛlɪ
პირველმოწამე	pʼirvɛlmɔtsʼɑmɛ	pʼɪrvɛlmɔtsʼɑmɛ
პირველობა	pʼirvɛlɔbɑ	pʼɪrvɛlɔbɑ
პირი	pʼiri	pʼɪrɪ
პირმოთნე	pʼirmɔtʰnɛ	pʼɪrmɔtʰnɛ
პირმშო	pʼirmʃɔ	pʼɪrmʃɔ
პირობა	pʼirɔbɑ	pʼɪrɔbɑ
პირობითი	pʼirɔbitʰi	pʼɪrɔbɪtʰɪ
პიროვნება	pʼirɔvnɛbɑ	pʼɪrɔvnɛbɑ
პირსახოცი	pʼirsɑxɔtsi	pʼɪrsɑχɔtsɪ
პირუკუ	pʼirukʼu	pʼɪrukʼu
პირუტყვი	pʼirutʼqʼvi	pʼɪrutʼqʼvɪ
პირუტყვობა	pʼirutʼqʼvɔbɑ	pʼɪrutʼqʼvɔbɑ
პისტოლეტი	pʼistʼɔlɛtʼi	pʼɪstʼɔlɛtʼɪ
პიტალო	pʼitʼɑlɔ	pʼɪtʼɑlɔ
პიტნა	pʼitʼnɑ	pʼɪtʼnɑ
პლაგიატი	pʼlɑɡiɑtʼi	pʼlɑɡɪɑtʼɪ
პლასტიკური	pʼlɑstʼikʼuri	pʼlɑstʼɪkʼurɪ
პლატინა	pʼlɑtʼinɑ	pʼlɑtʼɪnɑ
პლებეი	pʼlɛbɛi	pʼlɛbɛɪ
პლუტონი	pʼlutʼɔni	pʼlutʼɔnɪ
პოზიტიური	pʼɔzitʼiuri	pʼɔzɪtʼɪurɪ
პოლარული	pʼɔlɑruli	pʼɔlɑrulɪ
პოლიტიკური	pʼɔlitʼikʼuri	pʼɔlɪtʼɪkʼurɪ
პოლონეთი	pʼɔlɔnɛtʰi	pʼɔlɔnɛtʰɪ
პოლონიუმი	pʼɔlɔniumi	pʼɔlɔnɪumɪ
პოლუსი	pʼɔlusi	pʼɔlusɪ
პონტონი	pʼɔntʼɔni	pʼɔntʼɔnɪ
პორნოგრაფია	pʼɔrnɔɡrɑpʰiɑ	pʼɔrnɔɡrɑpʰɪɑ
პორტრეტისტი	pʼɔrtʼrɛtʼistʼi	pʼɔrtʼrɛtʼɪstʼɪ
პორტუგალია	pʼɔrtʼuɡɑliɑ	pʼɔrtʼuɡɑlɪɑ
პოტენციური	pʼɔtʼɛntsiuri	pʼɔtʼɛntsɪurɪ
პრაგმატიზმი	pʼrɑɡmɑtʼizmi	pʼrɑɡmɑtʼɪzmɪ
პრაზეოდიმიუმი	pʼrɑzɛɔdimiumi	pʼrɑzɛɔdɪmɪumɪ
პრაკი	pʼrɑkʼi	pʼrɑkʼɪ
პრასი	pʼrɑsi	pʼrɑsɪ
პრაქტიკული	pʼrɑkʰtʼikʼuli	pʼrɑkʰtʼɪkʼulɪ
პროგრესული	pʼrɔɡrɛsuli	pʼrɔɡrɛsulɪ
პროდუქტი	pʼrɔdukʰtʼi	pʼrɔdukʰtʼɪ
პროვინცია	pʼrɔvintsiɑ	pʼrɔvɪntsɪɑ
პროვოკაცია	pʼrɔvɔkʼɑtsiɑ	pʼrɔvɔkʼɑtsɪɑ
პრომეთიუმი	pʼrɔmɛtʰiumi	pʼrɔmɛtʰɪumɪ
პროპორციული	pʼrɔpʼɔrtsiuli	pʼrɔpʼɔrtsɪulɪ
პროტაქტინიუმი	pʼrɔtʼɑkʰtʼiniumi	pʼrɔtʼɑkʰtʼɪnɪumɪ
პროტესტანტიზმი	pʼrɔtʼɛstʼɑntʼizmi	pʼrɔtʼɛstʼɑntʼɪzmɪ
პროფესიონალი	pʼrɔpʰɛsiɔnɑli	pʼrɔpʰɛsɪɔnɑlɪ
პროფესიული	pʼrɔpʰɛsiuli	pʼrɔpʰɛsɪulɪ
პროფილაქტიკა	pʼrɔpʰilɑkʰtʼikʼɑ	pʼrɔpʰɪlɑkʰtʼɪkʼɑ
პროჭი	pʼrɔtʃʼi	pʼrɔtʃʼɪ
პულიმიოტი	pʼulimiɔtʼi	pʼulɪmɪɔtʼɪ
პუნქტი	pʼunkʰtʼi	pʼunkʰtʼɪ
პუნქტუაცია	pʼunkʰtʼuɑtsiɑ	pʼunkʰtʼuɑtsɪɑ
პური	pʼuri	pʼurɪ
ჟამი	ʒɑmi	ʒɑmɪ
ჟანგბადი	ʒɑnɡbɑdi	ʒɑnɡbɑdɪ
ჟანგი	ʒɑnɡi	ʒɑnɡɪ
ჟესტი	ʒɛstʼi	ʒɛstʼɪ
ჟვანია	ʒvɑniɑ	ʒvɑnɪɑ
ჟიპიტაური	ʒipʼitʼɑuri	ʒɪpʼɪtʼɑurɪ
ჟირაფი	ʒirɑpʰi	ʒɪrɑpʰɪ
ჟოკეი	ʒɔkʼɛi	ʒɔkʼɛɪ
ჟონგლიორობა	ʒɔnɡliɔrɔbɑ	ʒɔnɡlɪɔrɔbɑ
ჟღვლემს	ʒɣvlɛms	ʒʁvlɛms
რაბინი	rɑbini	rɑbɪnɪ
რადიოლოკაცია	rɑdiɔlɔkʼɑtsiɑ	rɑdɪɔlɔkʼɑtsɪɑ
რადონი	rɑdɔni	rɑdɔnɪ
რაები	rɑɛbi	rɑɛbɪ
რაიმე	rɑimɛ	rɑɪmɛ
რაინდი	rɑindi	rɑɪndɪ
რამდენი	rɑmdɛni	rɑmdɛnɪ
რამდენიმე	rɑmdɛnimɛ	rɑmdɛnɪmɛ
რამიშვილი	rɑmiʃvili	rɑmɪʃvɪlɪ
რამოდენი	rɑmɔdɛni	rɑmɔdɛnɪ
რამოდენიმე	rɑmɔdɛnimɛ	rɑmɔdɛnɪmɛ
რაოდენობითი	rɑɔdɛnɔbitʰi	rɑɔdɛnɔbɪtʰɪ
რატი	rɑtʼi	rɑtʼɪ
რაღა	rɑɣɑ	rɑʁɑ
რაღაც	rɑɣɑts	rɑʁɑts
რაღაცა	rɑɣɑtsɑ	rɑʁɑtsɑ
რაღაცეები	rɑɣɑtsɛɛbi	rɑʁɑtsɛɛbɪ
რაყიფი	rɑqʼipʰi	rɑqʼɪpʰɪ
რაციონალური	rɑtsiɔnɑluri	rɑtsɪɔnɑlurɪ
რახსი	rɑxsi	rɑχsɪ
რბილი	rbili	rbɪlɪ
რგოლი	rɡɔli	rɡɔlɪ
რეალიზაცია	rɛɑlizɑtsiɑ	rɛɑlɪzɑtsɪɑ
რეალიზმი	rɛɑlizmi	rɛɑlɪzmɪ
რეალისტური	rɛɑlistʼuri	rɛɑlɪstʼurɪ
რეალური	rɛɑluri	rɛɑlurɪ
რეაქცია	rɛɑkʰtsiɑ	rɛɑkʰtsɪɑ
რეგიონალური	rɛɡiɔnɑluri	rɛɡɪɔnɑlurɪ
რეგისტრატურა	rɛɡistʼrɑtʼurɑ	rɛɡɪstʼrɑtʼurɑ
რედაქტორი	rɛdɑkʰtʼɔri	rɛdɑkʰtʼɔrɪ
რევაზი	rɛvɑzi	rɛvɑzɪ
რევოლვერი	rɛvɔlvɛri	rɛvɔlvɛrɪ
რევოლუცია	rɛvɔlutsiɑ	rɛvɔlutsɪɑ
რეზიკო	rɛzikʼɔ	rɛzɪkʼɔ
რეიტინგი	rɛitʼinɡi	rɛɪtʼɪnɡɪ
რელიგია	rɛliɡiɑ	rɛlɪɡɪɑ
რენიუმი	rɛniumi	rɛnɪumɪ
რენტაბელური	rɛntʼɑbɛluri	rɛntʼɑbɛlurɪ
რენტგენი	rɛntʼɡɛni	rɛntʼɡɛnɪ
რეპეტიცია	rɛpʼɛtʼitsiɑ	rɛpʼɛtʼɪtsɪɑ
რეპლიკა	rɛpʼlikʼɑ	rɛpʼlɪkʼɑ
რეპროდუქცია	rɛpʼrɔdukʰtsiɑ	rɛpʼrɔdukʰtsɪɑ
რეჟიმი	rɛʒimi	rɛʒɪmɪ
რესპუბლიკა	rɛspʼublikʼɑ	rɛspʼublɪkʼɑ
რესტავრატორი	rɛstʼɑvrɑtʼɔri	rɛstʼɑvrɑtʼɔrɪ
რეფლექსი	rɛpʰlɛkʰsi	rɛpʰlɛkʰsɪ
რეცხვა	rɛtsxvɑ	rɛtsχvɑ
რვეული	rvɛuli	rvɛulɪ
რთული	rtʰuli	rtʰulɪ
რიგი	riɡi	rɪɡɪ
რითმა	ritʰmɑ	rɪtʰmɑ
რითმავს	ritʰmɑvs	rɪtʰmɑvs
რიკი	rikʼi	rɪkʼɪ
რიონი	riɔni	rɪɔnɪ
რიჟრაჟი	riʒrɑʒi	rɪʒrɑʒɪ
რისკი	riskʼi	rɪskʼɪ
რისხვა	risxvɑ	rɪsχvɑ
რიტმული	ritʼmuli	rɪtʼmulɪ
რიტორიკული	ritʼɔrikʼuli	rɪtʼɔrɪkʼulɪ
რიტუალი	ritʼuɑli	rɪtʼuɑlɪ
რიცხვი	ritsxvi	rɪtsχvɪ
რკალი	rkʼɑli	rkʼɑlɪ
რკინა	rkʼinɑ	rkʼɪnɑ
რკინაბეტონი	rkʼinɑbɛtʼɔni	rkʼɪnɑbɛtʼɔnɪ
რკინიგზა	rkʼiniɡzɑ	rkʼɪnɪɡzɑ
როდიუმი	rɔdiumi	rɔdɪumɪ
როლი	rɔli	rɔlɪ
რომელი	rɔmɛli	rɔmɛlɪ
რომელიც	rɔmɛlits	rɔmɛlɪts
როუმინგი	rɔuminɡi	rɔumɪnɡɪ
როქი	rɔkʰi	rɔkʰɪ
რუბიდიუმი	rubidiumi	rubɪdɪumɪ
რუთენიუმი	rutʰɛniumi	rutʰɛnɪumɪ
რუმინეთი	ruminɛtʰi	rumɪnɛtʰɪ
რუსეთი	rusɛtʰi	rusɛtʰɪ
რუსთაველი	rustʰɑvɛli	rustʰɑvɛlɪ
რუსთავი	rustʰɑvi	rustʰɑvɪ
რუსი	rusi	rusɪ
რჩეული	rtʃɛuli	rtʃɛulɪ
რჩილავს	rtʃilɑvs	rtʃɪlɑvs
რცხილა	rtsxilɑ	rtsχɪlɑ
რცხილაძე	rtsxilɑdzɛ	rtsχɪlɑdzɛ
რწმუნებული	rtsʼmunɛbuli	rtsʼmunɛbulɪ
რწყილი	rtsʼqʼili	rtsʼqʼɪlɪ
საათი	sɑɑtʰi	sɑɑtʰɪ
საათობრივად	sɑɑtʰɔbrivɑd	sɑɑtʰɔbrɪvɑd
სააკაშვილი	sɑɑkʼɑʃvili	sɑɑkʼɑʃvɪlɪ
საანგარიშო	sɑɑnɡɑriʃɔ	sɑɑnɡɑrɪʃɔ
საბაბი	sɑbɑbi	sɑbɑbɪ
საბაგირო	sɑbɑɡirɔ	sɑbɑɡɪrɔ
საბელი	sɑbɛli	sɑbɛlɪ
საბერძნეთი	sɑbɛrdznɛtʰi	sɑbɛrdznɛtʰɪ
საგალობელი	sɑɡɑlɔbɛli	sɑɡɑlɔbɛlɪ
საგიჟეთი	sɑɡiʒɛtʰi	sɑɡɪʒɛtʰɪ
სადაზღვევო	sɑdɑzɣvɛvɔ	sɑdɑzʁvɛvɔ
სადილი	sɑdili	sɑdɪlɪ
სადირექტორო	sɑdirɛkʰtʼɔrɔ	sɑdɪrɛkʰtʼɔrɔ
სადღეგრძელო	sɑdɣɛɡrdzɛlɔ	sɑdʁɛɡrdzɛlɔ
საენათმეცნიერო	sɑɛnɑtʰmɛtsniɛrɔ	sɑɛnɑtʰmɛtsnɪɛrɔ
საერთაშორისო	sɑɛrtʰɑʃɔrisɔ	sɑɛrtʰɑʃɔrɪsɔ
საერისთავო	sɑɛristʰɑvɔ	sɑɛrɪstʰɑvɔ
სავარძელი	sɑvɑrdzɛli	sɑvɑrdzɛlɪ
სავრცობი	sɑvrtsɔbi	sɑvrtsɔbɪ
საზრი	sɑzri	sɑzrɪ
საზრიანი	sɑzriɑni	sɑzrɪɑnɪ
საზღვაო	sɑzɣvɑɔ	sɑzʁvɑɔ
საზღვარი	sɑzɣvɑri	sɑzʁvɑrɪ
სათლი	sɑtʰli	sɑtʰlɪ
საიმედო	sɑimɛdɔ	sɑɪmɛdɔ
საინტერესო	sɑintʼɛrɛsɔ	sɑɪntʼɛrɛsɔ
საიტი	sɑitʼi	sɑɪtʼɪ
საკაიფო	sɑkʼɑipʰɔ	sɑkʼɑɪpʰɔ
საკეტი	sɑkʼɛtʼi	sɑkʼɛtʼɪ
საკვები	sɑkʼvɛbi	sɑkʼvɛbɪ
საკითხი	sɑkʼitʰxi	sɑkʼɪtʰχɪ
საკმარისად	sɑkʼmɑrisɑd	sɑkʼmɑrɪsɑd
საკმარისი	sɑkʼmɑrisi	sɑkʼmɑrɪsɪ
საკუთარი	sɑkʼutʰɑri	sɑkʼutʰɑrɪ
სალამი	sɑlɑmi	sɑlɑmɪ
სალამური	sɑlɑmuri	sɑlɑmurɪ
სალვადორი	sɑlvɑdɔri	sɑlvɑdɔrɪ
სალი	sɑli	sɑlɪ
სამანი	sɑmɑni	sɑmɑnɪ
სამართალი	sɑmɑrtʰɑli	sɑmɑrtʰɑlɪ
სამარიუმი	sɑmɑriumi	sɑmɑrɪumɪ
სამარცხვინო	sɑmɑrtsxvinɔ	sɑmɑrtsχvɪnɔ
სამაჯური	sɑmɑdʒuri	sɑmɑdʒurɪ
სამგლოვიარო	sɑmɡlɔviɑrɔ	sɑmɡlɔvɪɑrɔ
სამედიცინო	sɑmɛditsinɔ	sɑmɛdɪtsɪnɔ
სამი	sɑmi	sɑmɪ
სამკუთხედი	sɑmkʼutʰxɛdi	sɑmkʼutʰχɛdɪ
სამმაგი	sɑmmɑɡi	sɑmmɑɡɪ
სამოთხე	sɑmɔtʰxɛ	sɑmɔtʰχɛ
სამოცდაათი	sɑmɔtsdɑɑtʰi	sɑmɔtsdɑɑtʰɪ
სამოცდაერთი	sɑmɔtsdɑɛrtʰi	sɑmɔtsdɑɛrtʰɪ
სამოცდაექვსი	sɑmɔtsdɑɛkʰvsi	sɑmɔtsdɑɛkʰvsɪ
სამოცდათერთმეტი	sɑmɔtsdɑtʰɛrtʰmɛtʼi	sɑmɔtsdɑtʰɛrtʰmɛtʼɪ
სამოცდათექვსმეტი	sɑmɔtsdɑtʰɛkʰvsmɛtʼi	sɑmɔtsdɑtʰɛkʰvsmɛtʼɪ
სამოცდათვრამეტი	sɑmɔtsdɑtʰvrɑmɛtʼi	sɑmɔtsdɑtʰvrɑmɛtʼɪ
სამოცდათოთხმეტი	sɑmɔtsdɑtʰɔtʰxmɛtʼi	sɑmɔtsdɑtʰɔtʰχmɛtʼɪ
სამოცდათორმეტი	sɑmɔtsdɑtʰɔrmɛtʼi	sɑmɔtsdɑtʰɔrmɛtʼɪ
სამოცდათხუთმეტი	sɑmɔtsdɑtʰxutʰmɛtʼi	sɑmɔtsdɑtʰχutʰmɛtʼɪ
სამოცდაოთხი	sɑmɔtsdɑɔtʰxi	sɑmɔtsdɑɔtʰχɪ
სამოცდაორი	sɑmɔtsdɑɔri	sɑmɔtsdɑɔrɪ
სამოცდასამი	sɑmɔtsdɑsɑmi	sɑmɔtsdɑsɑmɪ
სამოცდაშვიდი	sɑmɔtsdɑʃvidi	sɑmɔtsdɑʃvɪdɪ
სამოცდაჩვიდმეტი	sɑmɔtsdɑtʃvidmɛtʼi	sɑmɔtsdɑtʃvɪdmɛtʼɪ
სამოცდაცამეტი	sɑmɔtsdɑtsɑmɛtʼi	sɑmɔtsdɑtsɑmɛtʼɪ
სამოცდაცხრა	sɑmɔtsdɑtsxrɑ	sɑmɔtsdɑtsχrɑ
სამოცდაცხრამეტი	sɑmɔtsdɑtsxrɑmɛtʼi	sɑmɔtsdɑtsχrɑmɛtʼɪ
სამოცდახუთი	sɑmɔtsdɑxutʰi	sɑmɔtsdɑχutʰɪ
სამოცი	sɑmɔtsi	sɑmɔtsɪ
სამოციქულო	sɑmɔtsikʰulɔ	sɑmɔtsɪkʰulɔ
სამსახური	sɑmsɑxuri	sɑmsɑχurɪ
სამუმი	sɑmumi	sɑmumɪ
სამურაი	sɑmurɑi	sɑmurɑɪ
სამღვდელო	sɑmɣvdɛlɔ	sɑmʁvdɛlɔ
სამშაბათი	sɑmʃɑbɑtʰi	sɑmʃɑbɑtʰɪ
სამცხე	sɑmtsxɛ	sɑmtsχɛ
სამხრეთი	sɑmxrɛtʰi	sɑmχrɛtʰɪ
სამხრეთული	sɑmxrɛtʰuli	sɑmχrɛtʰulɪ
სანაპირო	sɑnɑpʼirɔ	sɑnɑpʼɪrɔ
სანგარი	sɑnɡɑri	sɑnɡɑrɪ
სანთელი	sɑntʰɛli	sɑntʰɛlɪ
საპასუხო	sɑpʼɑsuxɔ	sɑpʼɑsuχɔ
საპატიმრო	sɑpʼɑtʼimrɔ	sɑpʼɑtʼɪmrɔ
საპატიო	sɑpʼɑtʼiɔ	sɑpʼɑtʼɪɔ
სარბიელი	sɑrbiɛli	sɑrbɪɛlɪ
სარდაფი	sɑrdɑpʰi	sɑrdɑpʰɪ
სარი	sɑri	sɑrɪ
სარიშვილი	sɑriʃvili	sɑrɪʃvɪlɪ
სარკმელი	sɑrkʼmɛli	sɑrkʼmɛlɪ
სარტყელი	sɑrtʼqʼɛli	sɑrtʼqʼɛlɪ
სასახლე	sɑsɑxlɛ	sɑsɑχlɛ
სასიამოვნო	sɑsiɑmɔvnɔ	sɑsɪɑmɔvnɔ
სასიკეთო	sɑsikʼɛtʰɔ	sɑsɪkʼɛtʰɔ
სასმელი	sɑsmɛli	sɑsmɛlɪ
სასომხეთი	sɑsɔmxɛtʰi	sɑsɔmχɛtʰɪ
სასტიკი	sɑstʼikʼi	sɑstʼɪkʼɪ
სასწაული	sɑstsʼɑuli	sɑstsʼɑulɪ
სასწორი	sɑstsʼɔri	sɑstsʼɔrɪ
სასხლეტი	sɑsxlɛtʼi	sɑsχlɛtʼɪ
სასხორელი	sɑsxɔrɛli	sɑsχɔrɛlɪ
სასხორი	sɑsxɔri	sɑsχɔrɪ
სატურნი	sɑtʼurni	sɑtʼurnɪ
საუცხოო	sɑutsxɔɔ	sɑutsχɔɔ
საუწყებათშორისოდ	sɑutsʼqʼɛbɑtʰʃɔrisɔd	sɑutsʼqʼɛbɑtʰʃɔrɪsɔd
საფარველი	sɑpʰɑrvɛli	sɑpʰɑrvɛlɪ
საფეთქელი	sɑpʰɛtʰkʰɛli	sɑpʰɛtʰkʰɛlɪ
საფეხბურთო	sɑpʰɛxburtʰɔ	sɑpʰɛχburtʰɔ
საფუარი	sɑpʰuɑri	sɑpʰuɑrɪ
საფუძველი	sɑpʰudzvɛli	sɑpʰudzvɛlɪ
საქმიანობს	sɑkʰmiɑnɔbs	sɑkʰmɪɑnɔbs
საქონელი	sɑkʰɔnɛli	sɑkʰɔnɛlɪ
საქციელი	sɑkʰtsiɛli	sɑkʰtsɪɛlɪ
საღამო	sɑɣɑmɔ	sɑʁɑmɔ
საღი	sɑɣi	sɑʁɪ
საღოლ	sɑɣɔl	sɑʁɔl
საღუზე	sɑɣuzɛ	sɑʁuzɛ
საყვარელი	sɑqʼvɑrɛli	sɑqʼvɑrɛlɪ
საყვარლები	sɑqʼvɑrlɛbi	sɑqʼvɑrlɛbɪ
საყვირი	sɑqʼviri	sɑqʼvɪrɪ
საცვალი	sɑtsvɑli	sɑtsvɑlɪ
საცობი	sɑtsɔbi	sɑtsɔbɪ
საცოდავი	sɑtsɔdɑvi	sɑtsɔdɑvɪ
საძირკველი	sɑdzirkʼvɛli	sɑdzɪrkʼvɛlɪ
საწოლი	sɑtsʼɔli	sɑtsʼɔlɪ
საწრუპავი	sɑtsʼrupʼɑvi	sɑtsʼrupʼɑvɪ
საწყალი	sɑtsʼqʼɑli	sɑtsʼqʼɑlɪ
სახალხო	sɑxɑlxɔ	sɑχɑlχɔ
სახე	sɑxɛ	sɑχɛ
სახელი	sɑxɛli	sɑχɛlɪ
სახელმწიფო	sɑxɛlmtsʼipʰɔ	sɑχɛlmtsʼɪpʰɔ
სახელობითი	sɑxɛlɔbitʰi	sɑχɛlɔbɪtʰɪ
სახელოვანი	sɑxɛlɔvɑni	sɑχɛlɔvɑnɪ
სახელოსნო	sɑxɛlɔsnɔ	sɑχɛlɔsnɔ
სახლი	sɑxli	sɑχlɪ
სახლში	sɑxlʃi	sɑχlʃɪ
სახურავი	sɑxurɑvi	sɑχurɑvɪ
სეირი	sɛiri	sɛɪrɪ
სეირნობს	sɛirnɔbs	sɛɪrnɔbs
სელენიუმი	sɛlɛniumi	sɛlɛnɪumɪ
სელი	sɛli	sɛlɪ
სემანტიკა	sɛmɑntʼikʼɑ	sɛmɑntʼɪkʼɑ
სემიტური	sɛmitʼuri	sɛmɪtʼurɪ
სენდვიჩი	sɛndvitʃi	sɛndvɪtʃɪ
სენეგალი	sɛnɛɡɑli	sɛnɛɡɑlɪ
სენსაცია	sɛnsɑtsiɑ	sɛnsɑtsɪɑ
სერბეთი	sɛrbɛtʰi	sɛrbɛtʰɪ
სერგი	sɛrɡi	sɛrɡɪ
სერი	sɛri	sɛrɪ
სეროზული	sɛrɔzuli	sɛrɔzulɪ
სექსუალური	sɛkʰsuɑluri	sɛkʰsuɑlurɪ
სექტორი	sɛkʰtʼɔri	sɛkʰtʼɔrɪ
სვაზილენდი	svɑzilɛndi	svɑzɪlɛndɪ
სვანეთი	svɑnɛtʰi	svɑnɛtʰɪ
სვანი	svɑni	svɑnɪ
სვანური	svɑnuri	svɑnurɪ
სვასტიკა	svɑstʼikʼɑ	svɑstʼɪkʼɑ
სველი	svɛli	svɛlɪ
სვეტი	svɛtʼi	svɛtʼɪ
სვეტიცხოველი	svɛtʼitsxɔvɛli	svɛtʼɪtsχɔvɛlɪ
სვირინგი	svirinɡi	svɪrɪnɡɪ
სთხოვს	stʰxɔvs	stʰχɔvs
სი	si	sɪ
სიადვილე	siɑdvilɛ	sɪɑdvɪlɛ
სიამაყე	siɑmɑqʼɛ	sɪɑmɑqʼɛ
სიანცე	siɑntsɛ	sɪɑntsɛ
სიარული	siɑruli	sɪɑrulɪ
სიაფანდი	siɑpʰɑndi	sɪɑpʰɑndɪ
სიაშკარავე	siɑʃkʼɑrɑvɛ	sɪɑʃkʼɑrɑvɛ
სიახლე	siɑxlɛ	sɪɑχlɛ
სიბაი	sibɑi	sɪbɑɪ
სიბასრე	sibɑsrɛ	sɪbɑsrɛ
სიბეჯითე	sibɛdʒitʰɛ	sɪbɛdʒɪtʰɛ
სიბინძურე	sibindzurɛ	sɪbɪndzurɛ
სიბლაგვე	siblɑɡvɛ	sɪblɑɡvɛ
სიბნელე	sibnɛlɛ	sɪbnɛlɛ
სიბოროტე	sibɔrɔtʼɛ	sɪbɔrɔtʼɛ
სიბრაზე	sibrɑzɛ	sɪbrɑzɛ
სიბრმავე	sibrmɑvɛ	sɪbrmɑvɛ
სიბრტყე	sibrtʼqʼɛ	sɪbrtʼqʼɛ
სიბრძნე	sibrdznɛ	sɪbrdznɛ
სიგამხდრე	siɡɑmxdrɛ	sɪɡɑmχdrɛ
სიგიჟე	siɡiʒɛ	sɪɡɪʒɛ
სიგრილე	siɡrilɛ	sɪɡrɪlɛ
სიგრძე	siɡrdzɛ	sɪɡrdzɛ
სიდაბლე	sidɑblɛ	sɪdɑblɛ
სიდამპლე	sidɑmpʼlɛ	sɪdɑmpʼlɛ
სიდამწვრე	sidɑmtsʼvrɛ	sɪdɑmtsʼvrɛ
სიდიადე	sidiɑdɛ	sɪdɪɑdɛ
სიდიდე	sididɛ	sɪdɪdɛ
სივერაგე	sivɛrɑɡɛ	sɪvɛrɑɡɛ
სივრცელე	sivrtsɛlɛ	sɪvrtsɛlɛ
სიზარმაცე	sizɑrmɑtsɛ	sɪzɑrmɑtsɛ
სიზმარი	sizmɑri	sɪzmɑrɪ
სიზუსტე	sizustʼɛ	sɪzustʼɛ
სითამამე	sitʰɑmɑmɛ	sɪtʰɑmɑmɛ
სითბო	sitʰbɔ	sɪtʰbɔ
სითბური	sitʰburi	sɪtʰburɪ
სითეთრე	sitʰɛtʰrɛ	sɪtʰɛtʰrɛ
სითხე	sitʰxɛ	sɪtʰχɛ
სიიაფე	siiɑpʰɛ	sɪɪɑpʰɛ
სიკარგე	sikʼɑrɡɛ	sɪkʼɑrɡɛ
სიკაშკაშე	sikʼɑʃkʼɑʃɛ	sɪkʼɑʃkʼɑʃɛ
სიკეთე	sikʼɛtʰɛ	sɪkʼɛtʰɛ
სიკვდილი	sikʼvdili	sɪkʼvdɪlɪ
სიკოჭლე	sikʼɔtʃʼlɛ	sɪkʼɔtʃʼlɛ
სილა	silɑ	sɪlɑ
სილამაზე	silɑmɑzɛ	sɪlɑmɑzɛ
სილიციუმი	silitsiumi	sɪlɪtsɪumɪ
სიმაგრე	simɑɡrɛ	sɪmɑɡrɛ
სიმამაცე	simɑmɑtsɛ	sɪmɑmɑtsɛ
სიმარდე	simɑrdɛ	sɪmɑrdɛ
სიმართლე	simɑrtʰlɛ	sɪmɑrtʰlɛ
სიმარჯვე	simɑrdʒvɛ	sɪmɑrdʒvɛ
სიმაღლე	simɑɣlɛ	sɪmɑʁlɛ
სიმახინჯე	simɑxindʒɛ	sɪmɑχɪndʒɛ
სიმბოლო	simbɔlɔ	sɪmbɔlɔ
სიმდაბლე	simdɑblɛ	sɪmdɑblɛ
სიმდიდრე	simdidrɛ	sɪmdɪdrɛ
სიმეტრიულად	simɛtʼriulɑd	sɪmɛtʼrɪulɑd
სიმეტრიული	simɛtʼriuli	sɪmɛtʼrɪulɪ
სიმინდი	simindi	sɪmɪndɪ
სიმკაცრე	simkʼɑtsrɛ	sɪmkʼɑtsrɛ
სიმკვეთრე	simkʼvɛtʰrɛ	sɪmkʼvɛtʰrɛ
სიმკვირცხლე	simkʼvirtsxlɛ	sɪmkʼvɪrtsχlɛ
სიმონია	simɔniɑ	sɪmɔnɪɑ
სიმპათიური	simpʼɑtʰiuri	sɪmpʼɑtʰɪurɪ
სიმპტომატური	simpʼtʼɔmɑtʼuri	sɪmpʼtʼɔmɑtʼurɪ
სიმრავლე	simrɑvlɛ	sɪmrɑvlɛ
სიმრგვალე	simrɡvɑlɛ	sɪmrɡvɑlɛ
სიმსივნე	simsivnɛ	sɪmsɪvnɛ
სიმსუბუქე	simsubukʰɛ	sɪmsubukʰɛ
სიმსუქნე	simsukʰnɛ	sɪmsukʰnɛ
სიმუნჯე	simundʒɛ	sɪmundʒɛ
სიმფონიური	simpʰɔniuri	sɪmpʰɔnɪurɪ
სიმღერა	simɣɛrɑ	sɪmʁɛrɑ
სიმყარე	simqʼɑrɛ	sɪmqʼɑrɛ
სიმყრალე	simqʼrɑlɛ	sɪmqʼrɑlɛ
სიმშვენიერე	simʃvɛniɛrɛ	sɪmʃvɛnɪɛrɛ
სიმშვიდე	simʃvidɛ	sɪmʃvɪdɛ
სიმშრალე	simʃrɑlɛ	sɪmʃrɑlɛ
სიმძაფრე	simdzɑpʰrɛ	sɪmdzɑpʰrɛ
სიმძიმე	simdzimɛ	sɪmdzɪmɛ
სიმწვანე	simtsʼvɑnɛ	sɪmtsʼvɑnɛ
სიმხდალე	simxdɑlɛ	sɪmχdɑlɛ
სიმხიარულე	simxiɑrulɛ	sɪmχɪɑrulɛ
სინაზე	sinɑzɛ	sɪnɑzɛ
სინათლე	sinɑtʰlɛ	sɪnɑtʰlɛ
სინამდვილე	sinɑmdvilɛ	sɪnɑmdvɪlɛ
სინამდვილეში	sinɑmdvilɛʃi	sɪnɑmdvɪlɛʃɪ
სინანული	sinɑnuli	sɪnɑnulɪ
სინანულით	sinɑnulitʰ	sɪnɑnulɪtʰ
სინატიფე	sinɑtʼipʰɛ	sɪnɑtʼɪpʰɛ
სინგაპური	sinɡɑpʼuri	sɪnɡɑpʼurɪ
სინდისი	sindisi	sɪndɪsɪ
სინდისიერი	sindisiɛri	sɪndɪsɪɛrɪ
სინელე	sinɛlɛ	sɪnɛlɛ
სინოპტიკური	sinɔpʼtʼikʼuri	sɪnɔpʼtʼɪkʼurɪ
სინუსი	sinusi	sɪnusɪ
სიო	siɔ	sɪɔ
სირბილე	sirbilɛ	sɪrbɪlɛ
სირბილი	sirbili	sɪrbɪlɪ
სირთულე	sirtʰulɛ	sɪrtʰulɛ
სირი	siri	sɪrɪ
სირია	siriɑ	sɪrɪɑ
სირცხვილი	sirtsxvili	sɪrtsχvɪlɪ
სისასტიკე	sisɑstʼikʼɛ	sɪsɑstʼɪkʼɛ
სისაძაგლე	sisɑdzɑɡlɛ	sɪsɑdzɑɡlɛ
სისაწყლე	sisɑtsʼqʼlɛ	sɪsɑtsʼqʼlɛ
სისინა	sisinɑ	sɪsɪnɑ
სისირი	sisiri	sɪsɪrɪ
სისრულე	sisrulɛ	sɪsrulɛ
სისტემა	sistʼɛmɑ	sɪstʼɛmɑ
სისულელე	sisulɛlɛ	sɪsulɛlɛ
სისუსტე	sisustʼɛ	sɪsustʼɛ
სისწორე	sistsʼɔrɛ	sɪstsʼɔrɛ
სისწრაფე	sistsʼrɑpʰɛ	sɪstsʼrɑpʰɛ
სისხლი	sisxli	sɪsχlɪ
სისხლიანი	sisxliɑni	sɪsχlɪɑnɪ
სისხლისღვრა	sisxlisɣvrɑ	sɪsχlɪsʁvrɑ
სისხლძარღვი	sisxldzɑrɣvi	sɪsχldzɑrʁvɪ
სიტკბო	sitʼkʼbɔ	sɪtʼkʼbɔ
სიტლანქე	sitʼlɑnkʰɛ	sɪtʼlɑnkʰɛ
სიტყვა	sitʼqʼvɑ	sɪtʼqʼvɑ
სიტყვაზე	sitʼqʼvɑzɛ	sɪtʼqʼvɑzɛ
სიტყვიერი	sitʼqʼviɛri	sɪtʼqʼvɪɛrɪ
სიუჟეტი	siuʒɛtʼi	sɪuʒɛtʼɪ
სიუხეშე	siuxɛʃɛ	sɪuχɛʃɛ
სიუხვე	siuxvɛ	sɪuχvɛ
სიფაქიზე	sipʰɑkʰizɛ	sɪpʰɑkʰɪzɛ
სიფერმკრთალე	sipʰɛrmkʼrtʰɑlɛ	sɪpʰɛrmkʼrtʰɑlɛ
სიფიცხე	sipʰitsxɛ	sɪpʰɪtsχɛ
სიფრთხილე	sipʰrtʰxilɛ	sɪpʰrtʰχɪlɛ
სიფხვიერე	sipʰxviɛrɛ	sɪpʰχvɪɛrɛ
სიფხიზლე	sipʰxizlɛ	sɪpʰχɪzlɛ
სიქა	sikʰɑ	sɪkʰɑ
სიქვრივე	sikʰvrivɛ	sɪkʰvrɪvɛ
სიქიზმი	sikʰizmi	sɪkʰɪzmɪ
სიღარიბე	siɣɑribɛ	sɪʁɑrɪbɛ
სიღატაკე	siɣɑtʼɑkʼɛ	sɪʁɑtʼɑkʼɛ
სიღრმე	siɣrmɛ	sɪʁrmɛ
სიყალბე	siqʼɑlbɛ	sɪqʼɑlbɛ
სიყვარული	siqʼvɑruli	sɪqʼvɑrulɪ
სიყვითლე	siqʼvitʰlɛ	sɪqʼvɪtʰlɛ
სიშავე	siʃɑvɛ	sɪʃɑvɛ
სიშიშვლე	siʃiʃvlɛ	sɪʃɪʃvlɛ
სიჩლუნგე	sitʃlunɡɛ	sɪtʃlunɡɛ
სიჩუმე	sitʃumɛ	sɪtʃumɛ
სიცარიელე	sitsɑriɛlɛ	sɪtsɑrɪɛlɛ
სიცელქე	sitsɛlkʰɛ	sɪtsɛlkʰɛ
სიცივე	sitsivɛ	sɪtsɪvɛ
სიცილი	sitsili	sɪtsɪlɪ
სიცოცხლე	sitsɔtsxlɛ	sɪtsɔtsχlɛ
სიცრუე	sitsruɛ	sɪtsruɛ
სიცხადე	sitsxɑdɛ	sɪtsχɑdɛ
სიცხე	sitsxɛ	sɪtsχɛ
სიცხოველე	sitsxɔvɛlɛ	sɪtsχɔvɛlɛ
სიძე	sidzɛ	sɪdzɛ
სიძლიერე	sidzliɛrɛ	sɪdzlɪɛrɛ
სიძნელე	sidznɛlɛ	sɪdznɛlɛ
სიძულვილი	sidzulvili	sɪdzulvɪlɪ
სიძუნწე	sidzuntsʼɛ	sɪdzuntsʼɛ
სიწვრილე	sitsʼvrilɛ	sɪtsʼvrɪlɛ
სიწმინდე	sitsʼmindɛ	sɪtsʼmɪndɛ
სიწრფელე	sitsʼrpʰɛlɛ	sɪtsʼrpʰɛlɛ
სიჭაბუკე	sitʃʼɑbukʼɛ	sɪtʃʼɑbukʼɛ
სიჭარბე	sitʃʼɑrbɛ	sɪtʃʼɑrbɛ
სიხარბე	sixɑrbɛ	sɪχɑrbɛ
სიხარული	sixɑruli	sɪχɑrulɪ
სიხშირე	sixʃirɛ	sɪχʃɪrɛ
სიჯანსაღე	sidʒɑnsɑɣɛ	sɪdʒɑnsɑʁɛ
სკამი	skʼɑmi	skʼɑmɪ
სკანდიუმი	skʼɑndiumi	skʼɑndɪumɪ
სკეპტიკური	skʼɛpʼtʼikʼuri	skʼɛpʼtʼɪkʼurɪ
სლავური	slɑvuri	slɑvurɪ
სლოვაკეთი	slɔvɑkʼɛtʰi	slɔvɑkʼɛtʰɪ
სლოვენია	slɔvɛniɑ	slɔvɛnɪɑ
სლოკინი	slɔkʼini	slɔkʼɪnɪ
სნეული	snɛuli	snɛulɪ
სოკრატული	sɔkʼrɑtʼuli	sɔkʼrɑtʼulɪ
სოლოლაკი	sɔlɔlɑkʼi	sɔlɔlɑkʼɪ
სომალი	sɔmɑli	sɔmɑlɪ
სომეხი	sɔmɛxi	sɔmɛχɪ
სომხეთი	sɔmxɛtʰi	sɔmχɛtʰɪ
სომხური	sɔmxuri	sɔmχurɪ
სოფელი	sɔpʰɛli	sɔpʰɛlɪ
სოციალიზმი	sɔtsiɑlizmi	sɔtsɪɑlɪzmɪ
სოციალისტური	sɔtsiɑlistʼuri	sɔtsɪɑlɪstʼurɪ
სოციალური	sɔtsiɑluri	sɔtsɪɑlurɪ
სოციოლოგიური	sɔtsiɔlɔɡiuri	sɔtsɪɔlɔɡɪurɪ
სოჭი	sɔtʃʼi	sɔtʃʼɪ
სპარსეთი	spʼɑrsɛtʰi	spʼɑrsɛtʰɪ
სპარსი	spʼɑrsi	spʼɑrsɪ
სპარსული	spʼɑrsuli	spʼɑrsulɪ
სპეტაკი	spʼɛtʼɑkʼi	spʼɛtʼɑkʼɪ
სპილენძი	spʼilɛndzi	spʼɪlɛndzɪ
სპილო	spʼilɔ	spʼɪlɔ
სრული	sruli	srulɪ
სრულიად	sruliɑd	srulɪɑd
სრულყოფილი	srulqʼɔpʰili	srulqʼɔpʰɪlɪ
სტატია	stʼɑtʼiɑ	stʼɑtʼɪɑ
სტაციონარული	stʼɑtsiɔnɑruli	stʼɑtsɪɔnɑrulɪ
სტვენით	stʼvɛnitʰ	stʼvɛnɪtʰ
სტიბიუმი	stʼibiumi	stʼɪbɪumɪ
სტიქიური	stʼikʰiuri	stʼɪkʰɪurɪ
სტკივა	stʼkʼivɑ	stʼkʼɪvɑ
სტოიკური	stʼɔikʼuri	stʼɔɪkʼurɪ
სტომატოლოგი	stʼɔmɑtʼɔlɔɡi	stʼɔmɑtʼɔlɔɡɪ
სტრონციუმი	stʼrɔntsiumi	stʼrɔntsɪumɪ
სტუდენტი	stʼudɛntʼi	stʼudɛntʼɪ
სუბიექტური	subiɛkʰtʼuri	subɪɛkʰtʼurɪ
სუდანი	sudɑni	sudɑnɪ
სუვენირი	suvɛniri	suvɛnɪrɪ
სულგრძელი	sulɡrdzɛli	sulɡrdzɛlɪ
სულელი	sulɛli	sulɛlɪ
სული	suli	sulɪ
სულიერი	suliɛri	sulɪɛrɪ
სუნელი	sunɛli	sunɛlɪ
სუნი	suni	sunɪ
სუპერმარკეტი	supʼɛrmɑrkʼɛtʼi	supʼɛrmɑrkʼɛtʼɪ
სურათი	surɑtʰi	surɑtʰɪ
სურამი	surɑmi	surɑmɪ
სურინამი	surinɑmi	surɪnɑmɪ
სუსტი	sustʼi	sustʼɪ
სქოლასტიკოსი	skʰɔlɑstʼikʼɔsi	skʰɔlɑstʼɪkʼɔsɪ
სცილდება	stsildɛbɑ	stsɪldɛbɑ
სწორი	stsʼɔri	stsʼɔrɪ
სწრაფი	stsʼrɑpʰi	stsʼrɑpʰɪ
სჭირდება	stʃʼirdɛbɑ	stʃʼɪrdɛbɑ
სხდომა	sxdɔmɑ	sχdɔmɑ
სხეული	sxɛuli	sχɛulɪ
სხვა	sxvɑ	sχvɑ
სხვადასხვა	sxvɑdɑsxvɑ	sχvɑdɑsχvɑ
სხვანაირი	sxvɑnɑiri	sχvɑnɑɪrɪ
სხვები	sxvɛbi	sχvɛbɪ
სხვენი	sxvɛni	sχvɛnɪ
სხვისი	sxvisi	sχvɪsɪ
სხივური	sxivuri	sχɪvurɪ
სჯის	sdʒis	sdʒɪs
ტაბაკი	tʼɑbɑkʼi	tʼɑbɑkʼɪ
ტავტოლოგია	tʼɑvtʼɔlɔɡiɑ	tʼɑvtʼɔlɔɡɪɑ
ტაილანდი	tʼɑilɑndi	tʼɑɪlɑndɪ
ტალახი	tʼɑlɑxi	tʼɑlɑχɪ
ტალახიანი	tʼɑlɑxiɑni	tʼɑlɑχɪɑnɪ
ტალღა	tʼɑlɣɑ	tʼɑlʁɑ
ტანზანია	tʼɑnzɑniɑ	tʼɑnzɑnɪɑ
ტანი	tʼɑni	tʼɑnɪ
ტანსაცმელი	tʼɑnsɑtsmɛli	tʼɑnsɑtsmɛlɪ
ტანტალი	tʼɑntʼɑli	tʼɑntʼɑlɪ
ტარაკანი	tʼɑrɑkʼɑni	tʼɑrɑkʼɑnɪ
ტარი	tʼɑri	tʼɑrɪ
ტასმანია	tʼɑsmɑniɑ	tʼɑsmɑnɪɑ
ტაშტი	tʼɑʃtʼi	tʼɑʃtʼɪ
ტაძარი	tʼɑdzɑri	tʼɑdzɑrɪ
ტახტი	tʼɑxtʼi	tʼɑχtʼɪ
ტაჯიკეთი	tʼɑdʒikʼɛtʰi	tʼɑdʒɪkʼɛtʰɪ
ტელევიზია	tʼɛlɛviziɑ	tʼɛlɛvɪzɪɑ
ტელური	tʼɛluri	tʼɛlurɪ
ტერბიუმი	tʼɛrbiumi	tʼɛrbɪumɪ
ტერიტორიული	tʼɛritʼɔriuli	tʼɛrɪtʼɔrɪulɪ
ტერფი	tʼɛrpʰi	tʼɛrpʰɪ
ტექნეციუმი	tʼɛkʰnɛtsiumi	tʼɛkʰnɛtsɪumɪ
ტექნიკური	tʼɛkʰnikʼuri	tʼɛkʰnɪkʼurɪ
ტექნოლოგიური	tʼɛkʰnɔlɔɡiuri	tʼɛkʰnɔlɔɡɪurɪ
ტვინად	tʼvinɑd	tʼvɪnɑd
ტვინებად	tʼvinɛbɑd	tʼvɪnɛbɑd
ტვინები	tʼvinɛbi	tʼvɪnɛbɪ
ტვინებით	tʼvinɛbitʰ	tʼvɪnɛbɪtʰ
ტვინების	tʼvinɛbis	tʼvɪnɛbɪs
ტვინებმა	tʼvinɛbmɑ	tʼvɪnɛbmɑ
ტვინებო	tʼvinɛbɔ	tʼvɪnɛbɔ
ტვინებს	tʼvinɛbs	tʼvɪnɛbs
ტვინთ	tʼvintʰ	tʼvɪntʰ
ტვინი	tʼvini	tʼvɪnɪ
ტვინით	tʼvinitʰ	tʼvɪnɪtʰ
ტვინის	tʼvinis	tʼvɪnɪs
ტვინმა	tʼvinmɑ	tʼvɪnmɑ
ტვინნი	tʼvinni	tʼvɪnnɪ
ტვინნო	tʼvinnɔ	tʼvɪnnɔ
ტვინო	tʼvinɔ	tʼvɪnɔ
ტვინს	tʼvins	tʼvɪns
ტვირთი	tʼvirtʰi	tʼvɪrtʰɪ
ტილი	tʼili	tʼɪlɪ
ტიპოლოგია	tʼipʼɔlɔɡiɑ	tʼɪpʼɔlɔɡɪɑ
ტიპურად	tʼipʼurɑd	tʼɪpʼurɑd
ტიპური	tʼipʼuri	tʼɪpʼurɪ
ტირე	tʼirɛ	tʼɪrɛ
ტირილი	tʼirili	tʼɪrɪlɪ
ტირის	tʼiris	tʼɪrɪs
ტიტა	tʼitʼɑ	tʼɪtʼɑ
ტიტანი	tʼitʼɑni	tʼɪtʼɑnɪ
ტიტველი	tʼitʼvɛli	tʼɪtʼvɛlɪ
ტკბილად	tʼkʼbilɑd	tʼkʼbɪlɑd
ტკბილი	tʼkʼbili	tʼkʼbɪlɪ
ტკივილი	tʼkʼivili	tʼkʼɪvɪlɪ
ტლანქი	tʼlɑnkʰi	tʼlɑnkʰɪ
ტოკიო	tʼɔkʼiɔ	tʼɔkʼɪɔ
ტოლი	tʼɔli	tʼɔlɪ
ტოლუმბაში	tʼɔlumbɑʃi	tʼɔlumbɑʃɪ
ტომი	tʼɔmi	tʼɔmɪ
ტოპოგრაფიული	tʼɔpʼɔɡrɑpʰiuli	tʼɔpʼɔɡrɑpʰɪulɪ
ტორფი	tʼɔrpʰi	tʼɔrpʰɪ
ტრაკი	tʼrɑkʼi	tʼrɑkʼɪ
ტრამვაი	tʼrɑmvɑi	tʼrɑmvɑɪ
ტრაპეცია	tʼrɑpʼɛtsiɑ	tʼrɑpʼɛtsɪɑ
ტრაქტი	tʼrɑkʰtʼi	tʼrɑkʰtʼɪ
ტრიპოლი	tʼripʼɔli	tʼrɪpʼɔlɪ
ტრიუმფალური	tʼriumpʰɑluri	tʼrɪumpʰɑlurɪ
ტროლი	tʼrɔli	tʼrɔlɪ
ტრუსიკი	tʼrusikʼi	tʼrusɪkʼɪ
ტუნისი	tʼunisi	tʼunɪsɪ
ტუჩები	tʼutʃɛbi	tʼutʃɛbɪ
ტუჩებით	tʼutʃɛbitʰ	tʼutʃɛbɪtʰ
ტუჩების	tʼutʃɛbis	tʼutʃɛbɪs
ტუჩი	tʼutʃi	tʼutʃɪ
ტუჩით	tʼutʃitʰ	tʼutʃɪtʰ
ტუჩის	tʼutʃis	tʼutʃɪs
ტუჩნი	tʼutʃni	tʼutʃnɪ
ტფილისი	tʼpʰilisi	tʼpʰɪlɪsɪ
ტყავი	tʼqʼɑvi	tʼqʼɑvɪ
ტყაპუჭი	tʼqʼɑpʼutʃʼi	tʼqʼɑpʼutʃʼɪ
ტყემალი	tʼqʼɛmɑli	tʼqʼɛmɑlɪ
ტყვარჩელი	tʼqʼvɑrtʃɛli	tʼqʼvɑrtʃɛlɪ
ტყვია	tʼqʼviɑ	tʼqʼvɪɑ
ტყვიამფრქვევი	tʼqʼviɑmpʰrkʰvɛvi	tʼqʼvɪɑmpʰrkʰvɛvɪ
ტყუილი	tʼqʼuili	tʼqʼuɪlɪ
ტყუპი	tʼqʼupʼi	tʼqʼupʼɪ
უადგილო	uɑdɡilɔ	uɑdɡɪlɔ
უადგილოდ	uɑdɡilɔd	uɑdɡɪlɔd
უარესი	uɑrɛsi	uɑrɛsɪ
უარი	uɑri	uɑrɪ
უბანი	ubɑni	ubɑnɪ
უბედური	ubɛduri	ubɛdurɪ
უდიდებულესობა	udidɛbulɛsɔbɑ	udɪdɛbulɛsɔbɑ
უდიერი	udiɛri	udɪɛrɪ
უდრის	udris	udrɪs
უელსი	uɛlsi	uɛlsɪ
უეჭველი	uɛtʃʼvɛli	uɛtʃʼvɛlɪ
უზბეკეთი	uzbɛkʼɛtʰi	uzbɛkʼɛtʰɪ
უზენაესი	uzɛnɑɛsi	uzɛnɑɛsɪ
უთვლადი	utʰvlɑdi	utʰvlɑdɪ
უიარაღო	uiɑrɑɣɔ	uɪɑrɑʁɔ
უიმედო	uimɛdɔ	uɪmɛdɔ
უინიციატივო	uinitsiɑtʼivɔ	uɪnɪtsɪɑtʼɪvɔ
უინტერესო	uintʼɛrɛsɔ	uɪntʼɛrɛsɔ
უიღბლო	uiɣblɔ	uɪʁblɔ
უკანალი	ukʼɑnɑli	ukʼɑnɑlɪ
უკანასკნელი	ukʼɑnɑskʼnɛli	ukʼɑnɑskʼnɛlɪ
უკაპიკო	ukʼɑpʼikʼɔ	ukʼɑpʼɪkʼɔ
უკბილო	ukʼbilɔ	ukʼbɪlɔ
უკიდურესი	ukʼidurɛsi	ukʼɪdurɛsɪ
უკმაყოფილება	ukʼmɑqʼɔpʰilɛbɑ	ukʼmɑqʼɔpʰɪlɛbɑ
უკომპრომისო	ukʼɔmpʼrɔmisɔ	ukʼɔmpʼrɔmɪsɔ
უკრაინა	ukʼrɑinɑ	ukʼrɑɪnɑ
უკრიტიკო	ukʼritʼikʼɔ	ukʼrɪtʼɪkʼɔ
უკრიტიკოდ	ukʼritʼikʼɔd	ukʼrɪtʼɪkʼɔd
ულვაში	ulvɑʃi	ulvɑʃɪ
უმარილო	umɑrilɔ	umɑrɪlɔ
უმარტივესი	umɑrtʼivɛsi	umɑrtʼɪvɛsɪ
უმაღლესი	umɑɣlɛsi	umɑʁlɛsɪ
უმახვილო	umɑxvilɔ	umɑχvɪlɔ
უმი	umi	umɪ
უმიზეზო	umizɛzɔ	umɪzɛzɔ
უმიზნო	umiznɔ	umɪznɔ
უმიწო	umitsʼɔ	umɪtsʼɔ
უმტკივნეულო	umtʼkʼivnɛulɔ	umtʼkʼɪvnɛulɔ
უმტკივნეულოდ	umtʼkʼivnɛulɔd	umtʼkʼɪvnɛulɔd
უმცირესობა	umtsirɛsɔbɑ	umtsɪrɛsɔbɑ
უმხედრო	umxɛdrɔ	umχɛdrɔ
უნარი	unɑri	unɑrɪ
უნარიანი	unɑriɑni	unɑrɪɑnɪ
უნარიანობა	unɑriɑnɔbɑ	unɑrɪɑnɔbɑ
უნგრეთი	unɡrɛtʰi	unɡrɛtʰɪ
უნივერსალური	univɛrsɑluri	unɪvɛrsɑlurɪ
უნუნოქტიუმი	ununɔkʰtʼiumi	ununɔkʰtʼɪumɪ
უნუნპენტიუმი	ununpʼɛntʼiumi	ununpʼɛntʼɪumɪ
უნუნსეპტიუმი	ununsɛpʼtʼiumi	ununsɛpʼtʼɪumɪ
უნუნტრიუმი	ununtʼriumi	ununtʼrɪumɪ
უპასუხო	upʼɑsuxɔ	upʼɑsuχɔ
უპატივცემლო	upʼɑtʼivtsɛmlɔ	upʼɑtʼɪvtsɛmlɔ
უპატიოსნო	upʼɑtʼiɔsnɔ	upʼɑtʼɪɔsnɔ
უპირატესობა	upʼirɑtʼɛsɔbɑ	upʼɪrɑtʼɛsɔbɑ
უპირო	upʼirɔ	upʼɪrɔ
უპირობო	upʼirɔbɔ	upʼɪrɔbɔ
უპიროდ	upʼirɔd	upʼɪrɔd
ურანი	urɑni	urɑnɪ
ურემი	urɛmi	urɛmɪ
ურთიერთობა	urtʰiɛrtʰɔbɑ	urtʰɪɛrtʰɔbɑ
ურია	uriɑ	urɪɑ
ურიგო	uriɡɔ	urɪɡɔ
ურუგვაი	uruɡvɑi	uruɡvɑɪ
ურყევი	urqʼɛvi	urqʼɛvɪ
ურჩი	urtʃi	urtʃɪ
ურჩხი	urtʃxi	urtʃχɪ
უსაზღვრო	usɑzɣvrɔ	usɑzʁvrɔ
უსაფრთხო	usɑpʰrtʰxɔ	usɑpʰrtʰχɔ
უსირცხვილო	usirtsxvilɔ	usɪrtsχvɪlɔ
უსირცხვილობა	usirtsxvilɔbɑ	usɪrtsχvɪlɔbɑ
უსიტყვო	usitʼqʼvɔ	usɪtʼqʼvɔ
უსიყვარულო	usiqʼvɑrulɔ	usɪqʼvɑrulɔ
უსტაბაში	ustʼɑbɑʃi	ustʼɑbɑʃɪ
უსხი	usxi	usχɪ
უტიფარი	utʼipʰɑri	utʼɪpʰɑrɪ
უტოპიური	utʼɔpʼiuri	utʼɔpʼɪurɪ
უტყვი	utʼqʼvi	utʼqʼvɪ
უფალი	upʰɑli	upʰɑlɪ
უფროსი	upʰrɔsi	upʰrɔsɪ
უქონელი	ukʰɔnɛli	ukʰɔnɛlɪ
უღელი	uɣɛli	uʁɛlɪ
უღონო	uɣɔnɔ	uʁɔnɔ
უშველის	uʃvɛlis	uʃvɛlɪs
უშვილო	uʃvilɔ	uʃvɪlɔ
უშიშარი	uʃiʃɑri	uʃɪʃɑrɪ
უშიშრად	uʃiʃrɑd	uʃɪʃrɑd
უშიშრობა	uʃiʃrɔbɑ	uʃɪʃrɔbɑ
უცხო	utsxɔ	utsχɔ
უძილო	udzilɔ	udzɪlɔ
უძრავი	udzrɑvi	udzrɑvɪ
უწესრიგო	utsʼɛsriɡɔ	utsʼɛsrɪɡɔ
უწინ	utsʼin	utsʼɪn
უწმინდური	utsʼminduri	utsʼmɪndurɪ
უწყვეტი	utsʼqʼvɛtʼi	utsʼqʼvɛtʼɪ
უხასიათო	uxɑsiɑtʰɔ	uχɑsɪɑtʰɔ
უხეშად	uxɛʃɑd	uχɛʃɑd
უხეში	uxɛʃi	uχɛʃɪ
უხვად	uxvɑd	uχvɑd
უხვი	uxvi	uχvɪ
უხსენებელი	uxsɛnɛbɛli	uχsɛnɛbɛlɪ
ფაგოტი	pʰɑɡɔtʼi	pʰɑɡɔtʼɪ
ფათერაკი	pʰɑtʰɛrɑkʼi	pʰɑtʰɛrɑkʼɪ
ფალოსი	pʰɑlɔsi	pʰɑlɔsɪ
ფანატიკური	pʰɑnɑtʼikʼuri	pʰɑnɑtʼɪkʼurɪ
ფანდური	pʰɑnduri	pʰɑndurɪ
ფანტელი	pʰɑntʼɛli	pʰɑntʼɛlɪ
ფანქარი	pʰɑnkʰɑri	pʰɑnkʰɑrɪ
ფარანი	pʰɑrɑni	pʰɑrɑnɪ
ფარგალი	pʰɑrɡɑli	pʰɑrɡɑlɪ
ფართობი	pʰɑrtʰɔbi	pʰɑrtʰɔbɪ
ფარი	pʰɑri	pʰɑrɪ
ფარიკაობა	pʰɑrikʼɑɔbɑ	pʰɑrɪkʼɑɔbɑ
ფარმაკოლოგია	pʰɑrmɑkʼɔlɔɡiɑ	pʰɑrmɑkʼɔlɔɡɪɑ
ფარშევანგი	pʰɑrʃɛvɑnɡi	pʰɑrʃɛvɑnɡɪ
ფარცხავს	pʰɑrtsxɑvs	pʰɑrtsχɑvs
ფასადი	pʰɑsɑdi	pʰɑsɑdɪ
ფასი	pʰɑsi	pʰɑsɪ
ფატალური	pʰɑtʼɑluri	pʰɑtʼɑlurɪ
ფაფარი	pʰɑpʰɑri	pʰɑpʰɑrɪ
ფაქიზად	pʰɑkʰizɑd	pʰɑkʰɪzɑd
ფაქიზი	pʰɑkʰizi	pʰɑkʰɪzɪ
ფაქტი	pʰɑkʰtʼi	pʰɑkʰtʼɪ
ფაქტიურად	pʰɑkʰtʼiurɑd	pʰɑkʰtʼɪurɑd
ფაქტობრივი	pʰɑkʰtʼɔbrivi	pʰɑkʰtʼɔbrɪvɪ
ფეისბუქი	pʰɛisbukʰi	pʰɛɪsbukʰɪ
ფელამუში	pʰɛlɑmuʃi	pʰɛlɑmuʃɪ
ფერდი	pʰɛrdi	pʰɛrdɪ
ფერეიდანი	pʰɛrɛidɑni	pʰɛrɛɪdɑnɪ
ფერია	pʰɛriɑ	pʰɛrɪɑ
ფერმკრთალი	pʰɛrmkʼrtʰɑli	pʰɛrmkʼrtʰɑlɪ
ფერფლი	pʰɛrpʰli	pʰɛrpʰlɪ
ფესვი	pʰɛsvi	pʰɛsvɪ
ფეტვი	pʰɛtʼvi	pʰɛtʼvɪ
ფეხბურთელი	pʰɛxburtʰɛli	pʰɛχburtʰɛlɪ
ფეხბურთი	pʰɛxburtʰi	pʰɛχburtʰɪ
ფეხი	pʰɛxi	pʰɛχɪ
ფეხიფეხგადადებული	pʰɛxipʰɛxɡɑdɑdɛbuli	pʰɛχɪpʰɛχɡɑdɑdɛbulɪ
ფეხმძიმე	pʰɛxmdzimɛ	pʰɛχmdzɪmɛ
ფეხმძიმობა	pʰɛxmdzimɔbɑ	pʰɛχmdzɪmɔbɑ
ფეხსაცმელი	pʰɛxsɑtsmɛli	pʰɛχsɑtsmɛlɪ
ფთორი	pʰtʰɔri	pʰtʰɔrɪ
ფიგურალური	pʰiɡurɑluri	pʰɪɡurɑlurɪ
ფიზიკა	pʰizikʼɑ	pʰɪzɪkʼɑ
ფიზიკური	pʰizikʼuri	pʰɪzɪkʼurɪ
ფითილი	pʰitʰili	pʰɪtʰɪlɪ
ფილიპინები	pʰilipʼinɛbi	pʰɪlɪpʼɪnɛbɪ
ფილტვი	pʰiltʼvi	pʰɪltʼvɪ
ფილტრავს	pʰiltʼrɑvs	pʰɪltʼrɑvs
ფინანსური	pʰinɑnsuri	pʰɪnɑnsurɪ
ფინეთი	pʰinɛtʰi	pʰɪnɛtʰɪ
ფინური	pʰinuri	pʰɪnurɪ
ფირალი	pʰirɑli	pʰɪrɑlɪ
ფიფია	pʰipʰiɑ	pʰɪpʰɪɑ
ფიფქია	pʰipʰkʰiɑ	pʰɪpʰkʰɪɑ
ფიქრი	pʰikʰri	pʰɪkʰrɪ
ფიქრიანად	pʰikʰriɑnɑd	pʰɪkʰrɪɑnɑd
ფიქრიანი	pʰikʰriɑni	pʰɪkʰrɪɑnɪ
ფიცარი	pʰitsɑri	pʰɪtsɑrɪ
ფიცარნაგი	pʰitsɑrnɑɡi	pʰɪtsɑrnɑɡɪ
ფიცი	pʰitsi	pʰɪtsɪ
ფიცხი	pʰitsxi	pʰɪtsχɪ
ფიჭვი	pʰitʃʼvi	pʰɪtʃʼvɪ
ფიჯი	pʰidʒi	pʰɪdʒɪ
ფლავი	pʰlɑvi	pʰlɑvɪ
ფლეიტა	pʰlɛitʼɑ	pʰlɛɪtʼɑ
ფლოტი	pʰlɔtʼi	pʰlɔtʼɪ
ფლუგერი	pʰluɡɛri	pʰluɡɛrɪ
ფოთი	pʰɔtʰi	pʰɔtʰɪ
ფოლადი	pʰɔlɑdi	pʰɔlɑdɪ
ფოლი	pʰɔli	pʰɔlɪ
ფორთოხალი	pʰɔrtʰɔxɑli	pʰɔrtʰɔχɑlɪ
ფორმალური	pʰɔrmɑluri	pʰɔrmɑlurɪ
ფორტეპიანო	pʰɔrtʼɛpʼiɑnɔ	pʰɔrtʼɛpʼɪɑnɔ
ფოსფორი	pʰɔspʰɔri	pʰɔspʰɔrɪ
ფოცხი	pʰɔtsxi	pʰɔtsχɪ
ფრაზეოლოგია	pʰrɑzɛɔlɔɡiɑ	pʰrɑzɛɔlɔɡɪɑ
ფრანგი	pʰrɑnɡi	pʰrɑnɡɪ
ფრანი	pʰrɑni	pʰrɑnɪ
ფრანციუმი	pʰrɑntsiumi	pʰrɑntsɪumɪ
ფრთიანი	pʰrtʰiɑni	pʰrtʰɪɑnɪ
ფრთხილად	pʰrtʰxilɑd	pʰrtʰχɪlɑd
ფრთხილი	pʰrtʰxili	pʰrtʰχɪlɪ
ფრიალო	pʰriɑlɔ	pʰrɪɑlɔ
ფრინველი	pʰrinvɛli	pʰrɪnvɛlɪ
ფრჩხილი	pʰrtʃxili	pʰrtʃχɪlɪ
ფსალმუნი	pʰsɑlmuni	pʰsɑlmunɪ
ფსევდონიმი	pʰsɛvdɔnimi	pʰsɛvdɔnɪmɪ
ფსელი	pʰsɛli	pʰsɛlɪ
ფსიქოლოგიური	pʰsikʰɔlɔɡiuri	pʰsɪkʰɔlɔɡɪurɪ
ფსონი	pʰsɔni	pʰsɔnɪ
ფული	pʰuli	pʰulɪ
ფუნქცია	pʰunkʰtsiɑ	pʰunkʰtsɪɑ
ფურთხი	pʰurtʰxi	pʰurtʰχɪ
ფური	pʰuri	pʰurɪ
ფურირემი	pʰurirɛmi	pʰurɪrɛmɪ
ფურცელი	pʰurtsɛli	pʰurtsɛlɪ
ფუტკარი	pʰutʼkʼɑri	pʰutʼkʼɑrɪ
ფუჩური	pʰutʃuri	pʰutʃurɪ
ფქვილი	pʰkʰvili	pʰkʰvɪlɪ
ფშავი	pʰʃɑvi	pʰʃɑvɪ
ფხვიერი	pʰxviɛri	pʰχvɪɛrɪ
ფხვნილი	pʰxvnili	pʰχvnɪlɪ
ფხიანი	pʰxiɑni	pʰχɪɑnɪ
ფხიზელი	pʰxizɛli	pʰχɪzɛlɪ
ქაბაბი	kʰɑbɑbi	kʰɑbɑbɪ
ქათამი	kʰɑtʰɑmi	kʰɑtʰɑmɪ
ქათმის	kʰɑtʰmis	kʰɑtʰmɪs
ქალაქი	kʰɑlɑkʰi	kʰɑlɑkʰɪ
ქალი	kʰɑli	kʰɑlɪ
ქალიშვილი	kʰɑliʃvili	kʰɑlɪʃvɪlɪ
ქალური	kʰɑluri	kʰɑlurɪ
ქალწული	kʰɑltsʼuli	kʰɑltsʼulɪ
ქანთალი	kʰɑntʰɑli	kʰɑntʰɑlɪ
ქანჩი	kʰɑntʃi	kʰɑntʃɪ
ქაოსი	kʰɑɔsi	kʰɑɔsɪ
ქაოტური	kʰɑɔtʼuri	kʰɑɔtʼurɪ
ქართველი	kʰɑrtʰvɛli	kʰɑrtʰvɛlɪ
ქართველური	kʰɑrtʰvɛluri	kʰɑrtʰvɛlurɪ
ქართლი	kʰɑrtʰli	kʰɑrtʰlɪ
ქართული	kʰɑrtʰuli	kʰɑrtʰulɪ
ქარი	kʰɑri	kʰɑrɪ
ქარიანი	kʰɑriɑni	kʰɑrɪɑnɪ
ქარპირა	kʰɑrpʼirɑ	kʰɑrpʼɪrɑ
ქარსი	kʰɑrsi	kʰɑrsɪ
ქარქაში	kʰɑrkʰɑʃi	kʰɑrkʰɑʃɪ
ქაღალდი	kʰɑɣɑldi	kʰɑʁɑldɪ
ქაშვეთი	kʰɑʃvɛtʰi	kʰɑʃvɛtʰɪ
ქაჩალი	kʰɑtʃɑli	kʰɑtʃɑlɪ
ქაჯი	kʰɑdʒi	kʰɑdʒɪ
ქედი	kʰɛdi	kʰɛdɪ
ქეთევანი	kʰɛtʰɛvɑni	kʰɛtʰɛvɑnɪ
ქეთი	kʰɛtʰi	kʰɛtʰɪ
ქეთინო	kʰɛtʰinɔ	kʰɛtʰɪnɔ
ქეიფი	kʰɛipʰi	kʰɛɪpʰɪ
ქელეხი	kʰɛlɛxi	kʰɛlɛχɪ
ქერუბიმი	kʰɛrubimi	kʰɛrubɪmɪ
ქვაბი	kʰvɑbi	kʰvɑbɪ
ქვევრი	kʰvɛvri	kʰvɛvrɪ
ქვეითი	kʰvɛitʰi	kʰvɛɪtʰɪ
ქველი	kʰvɛli	kʰvɛlɪ
ქვემეხი	kʰvɛmɛxi	kʰvɛmɛχɪ
ქვესკნელი	kʰvɛskʼnɛli	kʰvɛskʼnɛlɪ
ქვეყნის	kʰvɛqʼnis	kʰvɛqʼnɪs
ქვეწარმავალი	kʰvɛtsʼɑrmɑvɑli	kʰvɛtsʼɑrmɑvɑlɪ
ქვითავს	kʰvitʰɑvs	kʰvɪtʰɑvs
ქვითარი	kʰvitʰɑri	kʰvɪtʰɑrɪ
ქვითინით	kʰvitʰinitʰ	kʰvɪtʰɪnɪtʰ
ქვიშა	kʰviʃɑ	kʰvɪʃɑ
ქვიშაქვა	kʰviʃɑkʰvɑ	kʰvɪʃɑkʰvɑ
ქვრივი	kʰvrivi	kʰvrɪvɪ
ქვრივიშვილი	kʰvriviʃvili	kʰvrɪvɪʃvɪlɪ
ქილა	kʰilɑ	kʰɪlɑ
ქიმიური	kʰimiuri	kʰɪmɪurɪ
ქინქლი	kʰinkʰli	kʰɪnkʰlɪ
ქინძისთავი	kʰindzistʰɑvi	kʰɪndzɪstʰɑvɪ
ქირა	kʰirɑ	kʰɪrɑ
ქირავდება	kʰirɑvdɛbɑ	kʰɪrɑvdɛbɑ
ქირდავს	kʰirdɑvs	kʰɪrdɑvs
ქირდვა	kʰirdvɑ	kʰɪrdvɑ
ქირია	kʰiriɑ	kʰɪrɪɑ
ქირურგია	kʰirurɡiɑ	kʰɪrurɡɪɑ
ქისა	kʰisɑ	kʰɪsɑ
ქისტი	kʰistʼi	kʰɪstʼɪ
ქიტესაშვილი	kʰitʼɛsɑʃvili	kʰɪtʼɛsɑʃvɪlɪ
ქიტუაშვილი	kʰitʼuɑʃvili	kʰɪtʼuɑʃvɪlɪ
ქლიავი	kʰliɑvi	kʰlɪɑvɪ
ქლორი	kʰlɔri	kʰlɔrɪ
ქმარი	kʰmɑri	kʰmɑrɪ
ქობულეთი	kʰɔbulɛtʰi	kʰɔbulɛtʰɪ
ქომაგი	kʰɔmɑɡi	kʰɔmɑɡɪ
ქონი	kʰɔni	kʰɔnɪ
ქონიანად	kʰɔniɑnɑd	kʰɔnɪɑnɑd
ქონიანი	kʰɔniɑni	kʰɔnɪɑnɪ
ქორი	kʰɔri	kʰɔrɪ
ქორწინება	kʰɔrtsʼinɛbɑ	kʰɔrtsʼɪnɛbɑ
ქორჭილა	kʰɔrtʃʼilɑ	kʰɔrtʃʼɪlɑ
ქოქოსი	kʰɔkʰɔsi	kʰɔkʰɔsɪ
ქოჩორი	kʰɔtʃɔri	kʰɔtʃɔrɪ
ქოხი	kʰɔxi	kʰɔχɪ
ქრისტე	kʰristʼɛ	kʰrɪstʼɛ
ქრისტიანობა	kʰristʼiɑnɔbɑ	kʰrɪstʼɪɑnɔbɑ
ქრომი	kʰrɔmi	kʰrɔmɪ
ქსენონი	kʰsɛnɔni	kʰsɛnɔnɪ
ქსოვილი	kʰsɔvili	kʰsɔvɪlɪ
ქუდი	kʰudi	kʰudɪ
ქუვეითი	kʰuvɛitʰi	kʰuvɛɪtʰɪ
ქუთაისი	kʰutʰɑisi	kʰutʰɑɪsɪ
ქურდი	kʰurdi	kʰurdɪ
ღ	ɣ	ʁ
ღადაობა	ɣɑdɑɔbɑ	ʁɑdɑɔbɑ
ღალატი	ɣɑlɑtʼi	ʁɑlɑtʼɪ
ღამე	ɣɑmɛ	ʁɑmɛ
ღარავს	ɣɑrɑvs	ʁɑrɑvs
ღარი	ɣɑri	ʁɑrɪ
ღარიბი	ɣɑribi	ʁɑrɪbɪ
ღარიბულად	ɣɑribulɑd	ʁɑrɪbulɑd
ღარიბული	ɣɑribuli	ʁɑrɪbulɪ
ღატაკი	ɣɑtʼɑkʼi	ʁɑtʼɑkʼɪ
ღაწვი	ɣɑtsʼvi	ʁɑtsʼvɪ
ღებავს	ɣɛbɑvs	ʁɛbɑvs
ღერო	ɣɛrɔ	ʁɛrɔ
ღეჭავს	ɣɛtʃʼɑvs	ʁɛtʃʼɑvs
ღვარი	ɣvɑri	ʁvɑrɪ
ღვეზელი	ɣvɛzɛli	ʁvɛzɛlɪ
ღვთაება	ɣvtʰɑɛbɑ	ʁvtʰɑɛbɑ
ღვთისმშობელი	ɣvtʰismʃɔbɛli	ʁvtʰɪsmʃɔbɛlɪ
ღვთისმშობელმა	ɣvtʰismʃɔbɛlmɑ	ʁvtʰɪsmʃɔbɛlmɑ
ღვივილი	ɣvivili	ʁvɪvɪlɪ
ღვივის	ɣvivis	ʁvɪvɪs
ღვინო	ɣvinɔ	ʁvɪnɔ
ღვინოს	ɣvinɔs	ʁvɪnɔs
ღვიძლები	ɣvidzlɛbi	ʁvɪdzlɛbɪ
ღვიძლი	ɣvidzli	ʁvɪdzlɪ
ღია	ɣiɑ	ʁɪɑ
ღივი	ɣivi	ʁɪvɪ
ღიმი	ɣimi	ʁɪmɪ
ღიმილი	ɣimili	ʁɪmɪlɪ
ღირებულება	ɣirɛbulɛbɑ	ʁɪrɛbulɛbɑ
ღირს	ɣirs	ʁɪrs
ღირსეული	ɣirsɛuli	ʁɪrsɛulɪ
ღმერთი	ɣmɛrtʰi	ʁmɛrtʰɪ
ღობე	ɣɔbɛ	ʁɔbɛ
ღობემძვრალა	ɣɔbɛmdzvrɑlɑ	ʁɔbɛmdzvrɑlɑ
ღომი	ɣɔmi	ʁɔmɪ
ღონე	ɣɔnɛ	ʁɔnɛ
ღორი	ɣɔri	ʁɔrɪ
ღორღი	ɣɔrɣi	ʁɔrʁɪ
ღოჯი	ɣɔdʒi	ʁɔdʒɪ
ღრიალებს	ɣriɑlɛbs	ʁrɪɑlɛbs
ღრიალი	ɣriɑli	ʁrɪɑlɪ
ღრმა	ɣrmɑ	ʁrmɑ
ღრუბელი	ɣrubɛli	ʁrubɛlɪ
ღრძილი	ɣrdzili	ʁrdzɪlɪ
ღუზა	ɣuzɑ	ʁuzɑ
ღუმელი	ɣumɛli	ʁumɛlɪ
ღუნავს	ɣunɑvs	ʁunɑvs
ყაბაყი	qʼɑbɑqʼi	qʼɑbɑqʼɪ
ყაბული	qʼɑbuli	qʼɑbulɪ
ყაზაიშვილი	qʼɑzɑiʃvili	qʼɑzɑɪʃvɪlɪ
ყაზახეთად	qʼɑzɑxɛtʰɑd	qʼɑzɑχɛtʰɑd
ყაზახეთი	qʼɑzɑxɛtʰi	qʼɑzɑχɛtʰɪ
ყაზახეთით	qʼɑzɑxɛtʰitʰ	qʼɑzɑχɛtʰɪtʰ
ყაზახეთის	qʼɑzɑxɛtʰis	qʼɑzɑχɛtʰɪs
ყაზახეთმა	qʼɑzɑxɛtʰmɑ	qʼɑzɑχɛtʰmɑ
ყაზახეთო	qʼɑzɑxɛtʰɔ	qʼɑzɑχɛtʰɔ
ყაზახეთს	qʼɑzɑxɛtʰs	qʼɑzɑχɛtʰs
ყაიმი	qʼɑimi	qʼɑɪmɪ
ყაირათი	qʼɑirɑtʰi	qʼɑɪrɑtʰɪ
ყაირათიანი	qʼɑirɑtʰiɑni	qʼɑɪrɑtʰɪɑnɪ
ყალბი	qʼɑlbi	qʼɑlbɪ
ყარიბი	qʼɑribi	qʼɑrɪbɪ
ყარყუმი	qʼɑrqʼumi	qʼɑrqʼumɪ
ყასაბი	qʼɑsɑbi	qʼɑsɑbɪ
ყატარი	qʼɑtʼɑri	qʼɑtʼɑrɪ
ყაჩაღი	qʼɑtʃɑɣi	qʼɑtʃɑʁɪ
ყაჩაღობა	qʼɑtʃɑɣɔbɑ	qʼɑtʃɑʁɔbɑ
ყბადაღებული	qʼbɑdɑɣɛbuli	qʼbɑdɑʁɛbulɪ
ყბედი	qʼbɛdi	qʼbɛdɪ
ყელი	qʼɛli	qʼɛlɪ
ყვავი	qʼvɑvi	qʼvɑvɪ
ყვავილი	qʼvɑvili	qʼvɑvɪlɪ
ყველაფერი	qʼvɛlɑpʰɛri	qʼvɛlɑpʰɛrɪ
ყველი	qʼvɛli	qʼvɛlɪ
ყვითელი	qʼvitʰɛli	qʼvɪtʰɛlɪ
ყვირილი	qʼvirili	qʼvɪrɪlɪ
ყიდვა	qʼidvɑ	qʼɪdvɑ
ყიდის	qʼidis	qʼɪdɪs
ყიდულობს	qʼidulɔbs	qʼɪdulɔbs
ყინული	qʼinuli	qʼɪnulɪ
ყირგიზეთი	qʼirɡizɛtʰi	qʼɪrɡɪzɛtʰɪ
ყლორტი	qʼlɔrtʼi	qʼlɔrtʼɪ
ყლუპი	qʼlupʼi	qʼlupʼɪ
ყმაწვილი	qʼmɑtsʼvili	qʼmɑtsʼvɪlɪ
ყმაწვილობა	qʼmɑtsʼvilɔbɑ	qʼmɑtsʼvɪlɔbɑ
ყოველთვის	qʼɔvɛltʰvis	qʼɔvɛltʰvɪs
ყოველი	qʼɔvɛli	qʼɔvɛlɪ
ყორანი	qʼɔrɑni	qʼɔrɑnɪ
ყოჩაღ	qʼɔtʃɑɣ	qʼɔtʃɑʁ
ყოჩივარდა	qʼɔtʃivɑrdɑ	qʼɔtʃɪvɑrdɑ
ყუთი	qʼutʰi	qʼutʰɪ
ყურადღება	qʼurɑdɣɛbɑ	qʼurɑdʁɛbɑ
ყურები	qʼurɛbi	qʼurɛbɪ
ყური	qʼuri	qʼurɪ
ყურსასმენები	qʼursɑsmɛnɛbi	qʼursɑsmɛnɛbɪ
ყურსასმენი	qʼursɑsmɛni	qʼursɑsmɛnɪ
ყურძენი	qʼurdzɛni	qʼurdzɛnɪ
შაბათი	ʃɑbɑtʰi	ʃɑbɑtʰɪ
შაბი	ʃɑbi	ʃɑbɪ
შადრევანი	ʃɑdrɛvɑni	ʃɑdrɛvɑnɪ
შავარდენი	ʃɑvɑrdɛni	ʃɑvɑrdɛnɪ
შავი	ʃɑvi	ʃɑvɪ
შავლეგი	ʃɑvlɛɡi	ʃɑvlɛɡɪ
შალი	ʃɑli	ʃɑlɪ
შალიკაშვილი	ʃɑlikʼɑʃvili	ʃɑlɪkʼɑʃvɪlɪ
შამათი	ʃɑmɑtʰi	ʃɑmɑtʰɪ
შამპუნი	ʃɑmpʼuni	ʃɑmpʼunɪ
შამფური	ʃɑmpʰuri	ʃɑmpʰurɪ
შანსი	ʃɑnsi	ʃɑnsɪ
შარდი	ʃɑrdi	ʃɑrdɪ
შარვალი	ʃɑrvɑli	ʃɑrvɑlɪ
შარშანდელი	ʃɑrʃɑndɛli	ʃɑrʃɑndɛlɪ
შარშანწინ	ʃɑrʃɑntsʼin	ʃɑrʃɑntsʼɪn
შაქარი	ʃɑkʰɑri	ʃɑkʰɑrɪ
შაქარყინული	ʃɑkʰɑrqʼinuli	ʃɑkʰɑrqʼɪnulɪ
შაშვი	ʃɑʃvi	ʃɑʃvɪ
შაშიაშვილი	ʃɑʃiɑʃvili	ʃɑʃɪɑʃvɪlɪ
შაშხანა	ʃɑʃxɑnɑ	ʃɑʃχɑnɑ
შეგირდობა	ʃɛɡirdɔbɑ	ʃɛɡɪrdɔbɑ
შეგროვებული	ʃɛɡrɔvɛbuli	ʃɛɡrɔvɛbulɪ
შედეგი	ʃɛdɛɡi	ʃɛdɛɡɪ
შედევრი	ʃɛdɛvri	ʃɛdɛvrɪ
შეერთებული	ʃɛɛrtʰɛbuli	ʃɛɛrtʰɛbulɪ
შევარდენი	ʃɛvɑrdɛni	ʃɛvɑrdɛnɪ
შემაღლებული	ʃɛmɑɣlɛbuli	ʃɛmɑʁlɛbulɪ
შემზარავი	ʃɛmzɑrɑvi	ʃɛmzɑrɑvɪ
შემთხვევა	ʃɛmtʰxvɛvɑ	ʃɛmtʰχvɛvɑ
შემთხვევითი	ʃɛmtʰxvɛvitʰi	ʃɛmtʰχvɛvɪtʰɪ
შემოდის	ʃɛmɔdis	ʃɛmɔdɪs
შემოსავალი	ʃɛmɔsɑvɑli	ʃɛmɔsɑvɑlɪ
შემცდარი	ʃɛmtsdɑri	ʃɛmtsdɑrɪ
შემცვლელი	ʃɛmtsvlɛli	ʃɛmtsvlɛlɪ
შენი	ʃɛni	ʃɛnɪ
შენიშნავს	ʃɛniʃnɑvs	ʃɛnɪʃnɑvs
შესაბამისი	ʃɛsɑbɑmisi	ʃɛsɑbɑmɪsɪ
შესაბამისობა	ʃɛsɑbɑmisɔbɑ	ʃɛsɑbɑmɪsɔbɑ
შესამჩნევი	ʃɛsɑmtʃnɛvi	ʃɛsɑmtʃnɛvɪ
შესატყვისობა	ʃɛsɑtʼqʼvisɔbɑ	ʃɛsɑtʼqʼvɪsɔbɑ
შესახვევი	ʃɛsɑxvɛvi	ʃɛsɑχvɛvɪ
შეუბრალებელი	ʃɛubrɑlɛbɛli	ʃɛubrɑlɛbɛlɪ
შეუდრეკელი	ʃɛudrɛkʼɛli	ʃɛudrɛkʼɛlɪ
შეუზღუდავად	ʃɛuzɣudɑvɑd	ʃɛuzʁudɑvɑd
შეუზღუდავი	ʃɛuzɣudɑvi	ʃɛuzʁudɑvɪ
შეუპოვარი	ʃɛupʼɔvɑri	ʃɛupʼɔvɑrɪ
შეურაცხყოფა	ʃɛurɑtsxqʼɔpʰɑ	ʃɛurɑtsχqʼɔpʰɑ
შეურიგებლობა	ʃɛuriɡɛblɔbɑ	ʃɛurɪɡɛblɔbɑ
შეღწევადობა	ʃɛɣtsʼɛvɑdɔbɑ	ʃɛʁtsʼɛvɑdɔbɑ
შეყვარებული	ʃɛqʼvɑrɛbuli	ʃɛqʼvɑrɛbulɪ
შეშინებული	ʃɛʃinɛbuli	ʃɛʃɪnɛbulɪ
შეშლილი	ʃɛʃlili	ʃɛʃlɪlɪ
შეძლებული	ʃɛdzlɛbuli	ʃɛdzlɛbulɪ
შეხება	ʃɛxɛbɑ	ʃɛχɛbɑ
შეხვედრა	ʃɛxvɛdrɑ	ʃɛχvɛdrɑ
შვედეთი	ʃvɛdɛtʰi	ʃvɛdɛtʰɪ
შვედი	ʃvɛdi	ʃvɛdɪ
შვედური	ʃvɛduri	ʃvɛdurɪ
შვეიცარია	ʃvɛitsɑriɑ	ʃvɛɪtsɑrɪɑ
შვიდი	ʃvidi	ʃvɪdɪ
შვილი	ʃvili	ʃvɪlɪ
შვილიკო	ʃvilikʼɔ	ʃvɪlɪkʼɔ
შვილიშვილი	ʃviliʃvili	ʃvɪlɪʃvɪlɪ
შთაბეჭდილება	ʃtʰɑbɛtʃʼdilɛbɑ	ʃtʰɑbɛtʃʼdɪlɛbɑ
შიგნით	ʃiɡnitʰ	ʃɪɡnɪtʰ
შიდა	ʃidɑ	ʃɪdɑ
შიზოფრენია	ʃizɔpʰrɛniɑ	ʃɪzɔpʰrɛnɪɑ
შიკრიკი	ʃikʼrikʼi	ʃɪkʼrɪkʼɪ
შილი	ʃili	ʃɪlɪ
შიმშილი	ʃimʃili	ʃɪmʃɪlɪ
შინ	ʃin	ʃɪn
შინაური	ʃinɑuri	ʃɪnɑurɪ
შინდი	ʃindi	ʃɪndɪ
შინტოიზმი	ʃintʼɔizmi	ʃɪntʼɔɪzmɪ
შიშველი	ʃiʃvɛli	ʃɪʃvɛlɪ
შიში	ʃiʃi	ʃɪʃɪ
შიშინა	ʃiʃinɑ	ʃɪʃɪnɑ
შლის	ʃlis	ʃlɪs
შმაგი	ʃmɑɡi	ʃmɑɡɪ
შნოიანი	ʃnɔiɑni	ʃnɔɪɑnɪ
შოკოლადი	ʃɔkʼɔlɑdi	ʃɔkʼɔlɑdɪ
შოლტი	ʃɔltʼi	ʃɔltʼɪ
შორეული	ʃɔrɛuli	ʃɔrɛulɪ
შპრიცი	ʃpʼritsi	ʃpʼrɪtsɪ
შრომისმოყვარე	ʃrɔmismɔqʼvɑrɛ	ʃrɔmɪsmɔqʼvɑrɛ
შტატი	ʃtʼɑtʼi	ʃtʼɑtʼɪ
შტერი	ʃtʼɛri	ʃtʼɛrɪ
შუამავალი	ʃuɑmɑvɑli	ʃuɑmɑvɑlɪ
შუაში	ʃuɑʃi	ʃuɑʃɪ
შუბი	ʃubi	ʃubɪ
შუბლი	ʃubli	ʃublɪ
შურდული	ʃurduli	ʃurdulɪ
შური	ʃuri	ʃurɪ
შურისმაძიებლურად	ʃurismɑdziɛblurɑd	ʃurɪsmɑdzɪɛblurɑd
შუქნიშანი	ʃukʰniʃɑni	ʃukʰnɪʃɑnɪ
შქმერული	ʃkʰmɛruli	ʃkʰmɛrulɪ
შხამი	ʃxɑmi	ʃχɑmɪ
შხამიანი	ʃxɑmiɑni	ʃχɑmɪɑnɪ
ჩადი	tʃɑdi	tʃɑdɪ
ჩაეხუტება	tʃɑɛxutʼɛbɑ	tʃɑɛχutʼɛbɑ
ჩათლახი	tʃɑtʰlɑxi	tʃɑtʰlɑχɪ
ჩაიდანი	tʃɑidɑni	tʃɑɪdɑnɪ
ჩაინიკი	tʃɑinikʼi	tʃɑɪnɪkʼɪ
ჩაიხუტებს	tʃɑixutʼɛbs	tʃɑɪχutʼɛbs
ჩაკიდული	tʃɑkʼiduli	tʃɑkʼɪdulɪ
ჩალიჩი	tʃɑlitʃi	tʃɑlɪtʃɪ
ჩანგალი	tʃɑnɡɑli	tʃɑnɡɑlɪ
ჩართული	tʃɑrtʰuli	tʃɑrtʰulɪ
ჩარხი	tʃɑrxi	tʃɑrχɪ
ჩასაწვდომი	tʃɑsɑtsʼvdɔmi	tʃɑsɑtsʼvdɔmɪ
ჩაფი	tʃɑpʰi	tʃɑpʰɪ
ჩახარშავს	tʃɑxɑrʃɑvs	tʃɑχɑrʃɑvs
ჩახმახი	tʃɑxmɑxi	tʃɑχmɑχɪ
ჩახოხბილი	tʃɑxɔxbili	tʃɑχɔχbɪlɪ
ჩახტომა	tʃɑxtʼɔmɑ	tʃɑχtʼɔmɑ
ჩახუტება	tʃɑxutʼɛbɑ	tʃɑχutʼɛbɑ
ჩეკი	tʃɛkʼi	tʃɛkʼɪ
ჩემი	tʃɛmi	tʃɛmɪ
ჩემოდანი	tʃɛmɔdɑni	tʃɛmɔdɑnɪ
ჩერნოგორია	tʃɛrnɔɡɔriɑ	tʃɛrnɔɡɔrɪɑ
ჩერჩეტი	tʃɛrtʃɛtʼi	tʃɛrtʃɛtʼɪ
ჩეჩნეთი	tʃɛtʃnɛtʰi	tʃɛtʃnɛtʰɪ
ჩეხეთი	tʃɛxɛtʰi	tʃɛχɛtʰɪ
ჩვარი	tʃvɑri	tʃvɑrɪ
ჩვენი	tʃvɛni	tʃvɛnɪ
ჩვეულებრივი	tʃvɛulɛbrivi	tʃvɛulɛbrɪvɪ
ჩვიდმეტი	tʃvidmɛtʼi	tʃvɪdmɛtʼɪ
ჩიბუხი	tʃibuxi	tʃɪbuχɪ
ჩითი	tʃitʰi	tʃɪtʰɪ
ჩილე	tʃilɛ	tʃɪlɛ
ჩინეთი	tʃinɛtʰi	tʃɪnɛtʰɪ
ჩინოვნიკობა	tʃinɔvnikʼɔbɑ	tʃɪnɔvnɪkʼɔbɑ
ჩინური	tʃinuri	tʃɪnurɪ
ჩირქი	tʃirkʰi	tʃɪrkʰɪ
ჩიტი	tʃitʼi	tʃɪtʼɪ
ჩიხი	tʃixi	tʃɪχɪ
ჩიხირთმა	tʃixirtʰmɑ	tʃɪχɪrtʰmɑ
ჩიხუახუა	tʃixuɑxuɑ	tʃɪχuɑχuɑ
ჩლიქი	tʃlikʰi	tʃlɪkʰɪ
ჩლუნგი	tʃlunɡi	tʃlunɡɪ
ჩმორი	tʃmɔri	tʃmɔrɪ
ჩობანი	tʃɔbɑni	tʃɔbɑnɪ
ჩოგანი	tʃɔɡɑni	tʃɔɡɑnɪ
ჩოგბურთი	tʃɔɡburtʰi	tʃɔɡburtʰɪ
ჩონგური	tʃɔnɡuri	tʃɔnɡurɪ
ჩონჩხი	tʃɔntʃxi	tʃɔntʃχɪ
ჩოხა	tʃɔxɑ	tʃɔχɑ
ჩრდილი	tʃrdili	tʃrdɪlɪ
ჩრდილოეთი	tʃrdilɔɛtʰi	tʃrdɪlɔɛtʰɪ
ჩრჩილი	tʃrtʃili	tʃrtʃɪlɪ
ჩუმი	tʃumi	tʃumɪ
ჩურჩხელა	tʃurtʃxɛlɑ	tʃurtʃχɛlɑ
ჩუსტი	tʃustʼi	tʃustʼɪ
ჩხიკვი	tʃxikʼvi	tʃχɪkʼvɪ
ჩხუბი	tʃxubi	tʃχubɪ
ცალი	tsɑli	tsɑlɪ
ცამეტი	tsɑmɛtʼi	tsɑmɛtʼɪ
ცარიელი	tsɑriɛli	tsɑrɪɛlɪ
ცაციაშვილი	tsɑtsiɑʃvili	tsɑtsɪɑʃvɪlɪ
ცაცხვი	tsɑtsxvi	tsɑtsχvɪ
ცეზიუმი	tsɛziumi	tsɛzɪumɪ
ცელი	tsɛli	tsɛlɪ
ცელქი	tsɛlkʰi	tsɛlkʰɪ
ცენტრი	tsɛntʼri	tsɛntʼrɪ
ცერემონიულად	tsɛrɛmɔniulɑd	tsɛrɛmɔnɪulɑd
ცერი	tsɛri	tsɛrɪ
ცერიუმი	tsɛriumi	tsɛrɪumɪ
ცეცხლი	tsɛtsxli	tsɛtsχlɪ
ცეცხლს	tsɛtsxls	tsɛtsχls
ცეცხლსატყორცნი	tsɛtsxlsɑtʼqʼɔrtsni	tsɛtsχlsɑtʼqʼɔrtsnɪ
ცვალებადი	tsvɑlɛbɑdi	tsvɑlɛbɑdɪ
ცვეტში	tsvɛtʼʃi	tsvɛtʼʃɪ
ცვილი	tsvili	tsvɪlɪ
ცვლადი	tsvlɑdi	tsvlɑdɪ
ცვლილება	tsvlilɛbɑ	tsvlɪlɛbɑ
ცვრიანი	tsvriɑni	tsvrɪɑnɪ
ცივი	tsivi	tsɪvɪ
ციკლოპური	tsikʼlɔpʼuri	tsɪkʼlɔpʼurɪ
ციკლოტრონი	tsikʼlɔtʼrɔni	tsɪkʼlɔtʼrɔnɪ
ცილისწამება	tsilistsʼɑmɛbɑ	tsɪlɪstsʼɑmɛbɑ
ციმბირი	tsimbiri	tsɪmbɪrɪ
ცირკონიუმი	tsirkʼɔniumi	tsɪrkʼɔnɪumɪ
ცირცელი	tsirtsɛli	tsɪrtsɛlɪ
ცისარტყელა	tsisɑrtʼqʼɛlɑ	tsɪsɑrtʼqʼɛlɑ
ცისკარი	tsiskʼɑri	tsɪskʼɑrɪ
ცისფერი	tsispʰɛri	tsɪspʰɛrɪ
ციური	tsiuri	tsɪurɪ
ციფრი	tsipʰri	tsɪpʰrɪ
ციცინათელა	tsitsinɑtʰɛlɑ	tsɪtsɪnɑtʰɛlɑ
ციხე	tsixɛ	tsɪχɛ
ციხესიმაგრე	tsixɛsimɑɡrɛ	tsɪχɛsɪmɑɡrɛ
ცოლი	tsɔli	tsɔlɪ
ცომი	tsɔmi	tsɔmɪ
ცოფი	tsɔpʰi	tsɔpʰɪ
ცოცხალი	tsɔtsxɑli	tsɔtsχɑlɪ
ცოცხი	tsɔtsxi	tsɔtsχɪ
ცრემლი	tsrɛmli	tsrɛmlɪ
ცუდი	tsudi	tsudɪ
ცური	tsuri	tsurɪ
ცხადი	tsxɑdi	tsχɑdɪ
ცხარე	tsxɑrɛ	tsχɑrɛ
ცხელი	tsxɛli	tsχɛlɪ
ცხენი	tsxɛni	tsχɛnɪ
ცხვარი	tsxvɑri	tsχvɑrɪ
ცხვირი	tsxviri	tsχvɪrɪ
ცხვირსახოცი	tsxvirsɑxɔtsi	tsχvɪrsɑχɔtsɪ
ცხინვალი	tsxinvɑli	tsχɪnvɑlɪ
ცხოველი	tsxɔvɛli	tsχɔvɛlɪ
ცხოვრება	tsxɔvrɛbɑ	tsχɔvrɛbɑ
ცხოვრობს	tsxɔvrɔbs	tsχɔvrɔbs
ცხრა	tsxrɑ	tsχrɑ
ცხრამეტი	tsxrɑmɛtʼi	tsχrɑmɛtʼɪ
ძალიან	dzɑliɑn	dzɑlɪɑn
ძამაშვილი	dzɑmɑʃvili	dzɑmɑʃvɪlɪ
ძამია	dzɑmiɑ	dzɑmɪɑ
ძარღვი	dzɑrɣvi	dzɑrʁvɪ
ძაფი	dzɑpʰi	dzɑpʰɪ
ძაღლი	dzɑɣli	dzɑʁlɪ
ძაღლუკა	dzɑɣlukʼɑ	dzɑʁlukʼɑ
ძაღლური	dzɑɣluri	dzɑʁlurɪ
ძეგლი	dzɛɡli	dzɛɡlɪ
ძელი	dzɛli	dzɛlɪ
ძეხვი	dzɛxvi	dzɛχvɪ
ძვალი	dzvɑli	dzvɑlɪ
ძველი	dzvɛli	dzvɛlɪ
ძვლოვანი	dzvlɔvɑni	dzvlɔvɑnɪ
ძია	dziɑ	dzɪɑ
ძიება	dziɛbɑ	dzɪɛbɑ
ძილი	dzili	dzɪlɪ
ძირავს	dzirɑvs	dzɪrɑvs
ძირეული	dzirɛuli	dzɪrɛulɪ
ძირი	dziri	dzɪrɪ
ძირითადი	dziritʰɑdi	dzɪrɪtʰɑdɪ
ძიძიგური	dzidziɡuri	dzɪdzɪɡurɪ
ძლიერად	dzliɛrɑd	dzlɪɛrɑd
ძლიერი	dzliɛri	dzlɪɛrɪ
ძმაკაცი	dzmɑkʼɑtsi	dzmɑkʼɑtsɪ
ძმარი	dzmɑri	dzmɑrɪ
ძნელი	dznɛli	dznɛlɪ
ძრავი	dzrɑvi	dzrɑvɪ
ძროხა	dzrɔxɑ	dzrɔχɑ
ძუნწი	dzuntsʼi	dzuntsʼɪ
ძღვენი	dzɣvɛni	dzʁvɛnɪ
წაბლი	tsʼɑbli	tsʼɑblɪ
წადი	tsʼɑdi	tsʼɑdɪ
წავი	tsʼɑvi	tsʼɑvɪ
წალიკა	tsʼɑlikʼɑ	tsʼɑlɪkʼɑ
წალკოტი	tsʼɑlkʼɔtʼi	tsʼɑlkʼɔtʼɪ
წამალი	tsʼɑmɑli	tsʼɑmɑlɪ
წამი	tsʼɑmi	tsʼɑmɪ
წამოიწყებს	tsʼɑmɔitsʼqʼɛbs	tsʼɑmɔɪtsʼqʼɛbs
წამყვანი	tsʼɑmqʼvɑni	tsʼɑmqʼvɑnɪ
წამწამი	tsʼɑmtsʼɑmi	tsʼɑmtsʼɑmɪ
წარბი	tsʼɑrbi	tsʼɑrbɪ
წარმავალი	tsʼɑrmɑvɑli	tsʼɑrmɑvɑlɪ
წარმოუდგენელი	tsʼɑrmɔudɡɛnɛli	tsʼɑrmɔudɡɛnɛlɪ
წარჩინებული	tsʼɑrtʃinɛbuli	tsʼɑrtʃɪnɛbulɪ
წაუკითხავი	tsʼɑukʼitʰxɑvi	tsʼɑukʼɪtʰχɑvɪ
წევრი	tsʼɛvri	tsʼɛvrɪ
წელი	tsʼɛli	tsʼɛlɪ
წელიწადი	tsʼɛlitsʼɑdi	tsʼɛlɪtsʼɑdɪ
წერაქვი	tsʼɛrɑkʰvi	tsʼɛrɑkʰvɪ
წერილი	tsʼɛrili	tsʼɛrɪlɪ
წერტილი	tsʼɛrtʼili	tsʼɛrtʼɪlɪ
წესი	tsʼɛsi	tsʼɛsɪ
წესიერი	tsʼɛsiɛri	tsʼɛsɪɛrɪ
წესრიგი	tsʼɛsriɡi	tsʼɛsrɪɡɪ
წვენი	tsʼvɛni	tsʼvɛnɪ
წვერი	tsʼvɛri	tsʼvɛrɪ
წვივი	tsʼvivi	tsʼvɪvɪ
წვიმა	tsʼvimɑ	tsʼvɪmɑ
წვრილი	tsʼvrili	tsʼvrɪlɪ
წიაღი	tsʼiɑɣi	tsʼɪɑʁɪ
წიგნაკი	tsʼiɡnɑkʼi	tsʼɪɡnɑkʼɪ
წიგნი	tsʼiɡni	tsʼɪɡnɪ
წიდა	tsʼidɑ	tsʼɪdɑ
წითელა	tsʼitʰɛlɑ	tsʼɪtʰɛlɑ
წითელი	tsʼitʰɛli	tsʼɪtʰɛlɪ
წილი	tsʼili	tsʼɪlɪ
წინ	tsʼin	tsʼɪn
წინა	tsʼinɑ	tsʼɪnɑ
წინააღმდეგობა	tsʼinɑɑɣmdɛɡɔbɑ	tsʼɪnɑɑʁmdɛɡɔbɑ
წინადადება	tsʼinɑdɑdɛbɑ	tsʼɪnɑdɑdɛbɑ
წინადღე	tsʼinɑdɣɛ	tsʼɪnɑdʁɛ
წინამძღვარი	tsʼinɑmdzɣvɑri	tsʼɪnɑmdzʁvɑrɪ
წინაღობა	tsʼinɑɣɔbɑ	tsʼɪnɑʁɔbɑ
წინდა	tsʼindɑ	tsʼɪndɑ
წინსაფარი	tsʼinsɑpʰɑri	tsʼɪnsɑpʰɑrɪ
წინსვლა	tsʼinsvlɑ	tsʼɪnsvlɑ
წიპწა	tsʼipʼtsʼɑ	tsʼɪpʼtsʼɑ
წისქვილი	tsʼiskʰvili	tsʼɪskʰvɪlɪ
წიფელი	tsʼipʰɛli	tsʼɪpʰɛlɪ
წიწაკა	tsʼitsʼɑkʼɑ	tsʼɪtsʼɑkʼɑ
წიწილა	tsʼitsʼilɑ	tsʼɪtsʼɪlɑ
წიწმატი	tsʼitsʼmɑtʼi	tsʼɪtsʼmɑtʼɪ
წკიპურტი	tsʼkʼipʼurtʼi	tsʼkʼɪpʼurtʼɪ
წლიანი	tsʼliɑni	tsʼlɪɑnɪ
წლისთავი	tsʼlistʰɑvi	tsʼlɪstʰɑvɪ
წმიდა	tsʼmidɑ	tsʼmɪdɑ
წმინდა	tsʼmindɑ	tsʼmɪndɑ
წნელი	tsʼnɛli	tsʼnɛlɪ
წრეწირი	tsʼrɛtsʼiri	tsʼrɛtsʼɪrɪ
წრფელი	tsʼrpʰɛli	tsʼrpʰɛlɪ
წუთი	tsʼutʰi	tsʼutʰɪ
წული	tsʼuli	tsʼulɪ
წუნი	tsʼuni	tsʼunɪ
წუწუნი	tsʼutsʼuni	tsʼutsʼunɪ
წუწურაქი	tsʼutsʼurɑkʰi	tsʼutsʼurɑkʰɪ
წუხელ	tsʼuxɛl	tsʼuχɛl
წუხილი	tsʼuxili	tsʼuχɪlɪ
წყავი	tsʼqʼɑvi	tsʼqʼɑvɪ
წყალბადი	tsʼqʼɑlbɑdi	tsʼqʼɑlbɑdɪ
წყალდიდობა	tsʼqʼɑldidɔbɑ	tsʼqʼɑldɪdɔbɑ
წყალი	tsʼqʼɑli	tsʼqʼɑlɪ
წყვეტილი	tsʼqʼvɛtʼili	tsʼqʼvɛtʼɪlɪ
წყვილი	tsʼqʼvili	tsʼqʼvɪlɪ
წყლიანი	tsʼqʼliɑni	tsʼqʼlɪɑnɪ
წყლული	tsʼqʼluli	tsʼqʼlulɪ
წყლულიანი	tsʼqʼluliɑni	tsʼqʼlulɪɑnɪ
წყურვილი	tsʼqʼurvili	tsʼqʼurvɪlɪ
ჭაბუკი	tʃʼɑbukʼi	tʃʼɑbukʼɪ
ჭაბუკური	tʃʼɑbukʼuri	tʃʼɑbukʼurɪ
ჭადარი	tʃʼɑdɑri	tʃʼɑdɑrɪ
ჭადრაკი	tʃʼɑdrɑkʼi	tʃʼɑdrɑkʼɪ
ჭალაკი	tʃʼɑlɑkʼi	tʃʼɑlɑkʼɪ
ჭანჭიკი	tʃʼɑntʃʼikʼi	tʃʼɑntʃʼɪkʼɪ
ჭარბი	tʃʼɑrbi	tʃʼɑrbɪ
ჭერი	tʃʼɛri	tʃʼɛrɪ
ჭეშმარიტად	tʃʼɛʃmɑritʼɑd	tʃʼɛʃmɑrɪtʼɑd
ჭეშმარიტება	tʃʼɛʃmɑritʼɛbɑ	tʃʼɛʃmɑrɪtʼɛbɑ
ჭეშმარიტი	tʃʼɛʃmɑritʼi	tʃʼɛʃmɑrɪtʼɪ
ჭვავი	tʃʼvɑvi	tʃʼvɑvɪ
ჭვიშტარი	tʃʼviʃtʼɑri	tʃʼvɪʃtʼɑrɪ
ჭი	tʃʼi	tʃʼɪ
ჭიანაჭამი	tʃʼiɑnɑtʃʼɑmi	tʃʼɪɑnɑtʃʼɑmɪ
ჭიანჭველა	tʃʼiɑntʃʼvɛlɑ	tʃʼɪɑntʃʼvɛlɑ
ჭიდაობა	tʃʼidɑɔbɑ	tʃʼɪdɑɔbɑ
ჭიდილი	tʃʼidili	tʃʼɪdɪlɪ
ჭიმავს	tʃʼimɑvs	tʃʼɪmɑvs
ჭინჭრაქა	tʃʼintʃʼrɑkʰɑ	tʃʼɪntʃʼrɑkʰɑ
ჭიპი	tʃʼipʼi	tʃʼɪpʼɪ
ჭირი	tʃʼiri	tʃʼɪrɪ
ჭირისუფალი	tʃʼirisupʰɑli	tʃʼɪrɪsupʰɑlɪ
ჭიქა	tʃʼikʰɑ	tʃʼɪkʰɑ
ჭიშკარი	tʃʼiʃkʼɑri	tʃʼɪʃkʼɑrɪ
ჭიხვინი	tʃʼixvini	tʃʼɪχvɪnɪ
ჭონი	tʃʼɔni	tʃʼɔnɪ
ჭორი	tʃʼɔri	tʃʼɔrɪ
ჭრილი	tʃʼrili	tʃʼrɪlɪ
ჭრილობა	tʃʼrilɔbɑ	tʃʼrɪlɔbɑ
ჭუნირი	tʃʼuniri	tʃʼunɪrɪ
ჭურვი	tʃʼurvi	tʃʼurvɪ
ჭუჭყი	tʃʼutʃʼqʼi	tʃʼutʃʼqʼɪ
ჭყაპი	tʃʼqʼɑpʼi	tʃʼqʼɑpʼɪ
ხავსი	xɑvsi	χɑvsɪ
ხაზავს	xɑzɑvs	χɑzɑvs
ხათრიძე	xɑtʰridzɛ	χɑtʰrɪdzɛ
ხაკერი	xɑkʼɛri	χɑkʼɛrɪ
ხალავს	xɑlɑvs	χɑlɑvs
ხალათი	xɑlɑtʰi	χɑlɑtʰɪ
ხალასი	xɑlɑsi	χɑlɑsɪ
ხალი	xɑli	χɑlɪ
ხალიჩა	xɑlitʃɑ	χɑlɪtʃɑ
ხალხი	xɑlxi	χɑlχɪ
ხამლი	xɑmli	χɑmlɪ
ხანგრძლივი	xɑnɡrdzlivi	χɑnɡrdzlɪvɪ
ხანდახან	xɑndɑxɑn	χɑndɑχɑn
ხანი	xɑni	χɑnɪ
ხანჯალი	xɑndʒɑli	χɑndʒɑlɪ
ხარაჩო	xɑrɑtʃɔ	χɑrɑtʃɔ
ხარბი	xɑrbi	χɑrbɪ
ხარვეზი	xɑrvɛzi	χɑrvɛzɪ
ხარისხად	xɑrisxɑd	χɑrɪsχɑd
ხარისხით	xɑrisxitʰ	χɑrɪsχɪtʰ
ხარისხის	xɑrisxis	χɑrɪsχɪs
ხარისხმა	xɑrisxmɑ	χɑrɪsχmɑ
ხარისხს	xɑrisxs	χɑrɪsχs
ხარიხა	xɑrixɑ	χɑrɪχɑ
ხარშავს	xɑrʃɑvs	χɑrʃɑvs
ხარჩო	xɑrtʃɔ	χɑrtʃɔ
ხარხარი	xɑrxɑri	χɑrχɑrɪ
ხარჯავს	xɑrdʒɑvs	χɑrdʒɑvs
ხატვა	xɑtʼvɑ	χɑtʼvɑ
ხატია	xɑtʼiɑ	χɑtʼɪɑ
ხაფანგი	xɑpʰɑnɡi	χɑpʰɑnɡɪ
ხაში	xɑʃi	χɑʃɪ
ხაჩკარი	xɑtʃkʼɑri	χɑtʃkʼɑrɪ
ხაჭაპური	xɑtʃʼɑpʼuri	χɑtʃʼɑpʼurɪ
ხაჭო	xɑtʃʼɔ	χɑtʃʼɔ
ხახვი	xɑxvi	χɑχvɪ
ხდება	xdɛbɑ	χdɛbɑ
ხე	xɛ	χɛ
ხედ	xɛd	χɛd
ხეებად	xɛɛbɑd	χɛɛbɑd
ხეები	xɛɛbi	χɛɛbɪ
ხეებით	xɛɛbitʰ	χɛɛbɪtʰ
ხეების	xɛɛbis	χɛɛbɪs
ხეებმა	xɛɛbmɑ	χɛɛbmɑ
ხეებო	xɛɛbɔ	χɛɛbɔ
ხეებს	xɛɛbs	χɛɛbs
ხევ	xɛv	χɛv
ხევი	xɛvi	χɛvɪ
ხევისბერი	xɛvisbɛri	χɛvɪsbɛrɪ
ხევსურეთი	xɛvsurɛtʰi	χɛvsurɛtʰɪ
ხევსური	xɛvsuri	χɛvsurɪ
ხეთ	xɛtʰ	χɛtʰ
ხეთქა	xɛtʰkʰɑ	χɛtʰkʰɑ
ხელბურთი	xɛlburtʰi	χɛlburtʰɪ
ხელი	xɛli	χɛlɪ
ხელისგული	xɛlisɡuli	χɛlɪsɡulɪ
ხელმოკლე	xɛlmɔkʼlɛ	χɛlmɔkʼlɛ
ხელმწიფე	xɛlmtsʼipʰɛ	χɛlmtsʼɪpʰɛ
ხელობა	xɛlɔbɑ	χɛlɔbɑ
ხელოვნურად	xɛlɔvnurɑd	χɛlɔvnurɑd
ხელსაყრელად	xɛlsɑqʼrɛlɑd	χɛlsɑqʼrɛlɑd
ხელსაყრელი	xɛlsɑqʼrɛli	χɛlsɑqʼrɛlɪ
ხელსაწყო	xɛlsɑtsʼqʼɔ	χɛlsɑtsʼqʼɔ
ხელსახოცი	xɛlsɑxɔtsi	χɛlsɑχɔtsɪ
ხელწამოსაკრავი	xɛltsʼɑmɔsɑkʼrɑvi	χɛltsʼɑmɔsɑkʼrɑvɪ
ხემ	xɛm	χɛm
ხენდრო	xɛndrɔ	χɛndrɔ
ხენი	xɛni	χɛnɪ
ხენო	xɛnɔ	χɛnɔ
ხეპრე	xɛpʼrɛ	χɛpʼrɛ
ხერხავს	xɛrxɑvs	χɛrχɑvs
ხერხემალი	xɛrxɛmɑli	χɛrχɛmɑlɪ
ხერხი	xɛrxi	χɛrχɪ
ხეს	xɛs	χɛs
ხეტიალი	xɛtʼiɑli	χɛtʼɪɑlɪ
ხეხავს	xɛxɑvs	χɛχɑvs
ხვალ	xvɑl	χvɑl
ხვინჭი	xvintʃʼi	χvɪntʃʼɪ
ხვირიკა	xvirikʼɑ	χvɪrɪkʼɑ
ხვლიკი	xvlikʼi	χvlɪkʼɪ
ხვრელი	xvrɛli	χvrɛlɪ
ხვრეპს	xvrɛpʼs	χvrɛpʼs
ხვრინავს	xvrinɑvs	χvrɪnɑvs
ხიბლი	xibli	χɪblɪ
ხიდი	xidi	χɪdɪ
ხიზანიშვილი	xizɑniʃvili	χɪzɑnɪʃvɪlɪ
ხით	xitʰ	χɪtʰ
ხილი	xili	χɪlɪ
ხინკალი	xinkʼɑli	χɪnkʼɑlɪ
ხინჯი	xindʒi	χɪndʒɪ
ხის	xis	χɪs
ხიფათი	xipʰɑtʰi	χɪpʰɑtʰɪ
ხიშტი	xiʃtʼi	χɪʃtʼɪ
ხიჭი	xitʃʼi	χɪtʃʼɪ
ხლეჩს	xlɛtʃs	χlɛtʃs
ხმა	xmɑ	χmɑ
ხმალი	xmɑli	χmɑlɪ
ხმამაღლამოლაპარაკე	xmɑmɑɣlɑmɔlɑpʼɑrɑkʼɛ	χmɑmɑʁlɑmɔlɑpʼɑrɑkʼɛ
ხმაური	xmɑuri	χmɑurɪ
ხმაურიანი	xmɑuriɑni	χmɑurɪɑnɪ
ხმელეთი	xmɛlɛtʰi	χmɛlɛtʰɪ
ხმელი	xmɛli	χmɛlɪ
ხმის	xmis	χmɪs
ხნარცვი	xnɑrtsvi	χnɑrtsvɪ
ხო	xɔ	χɔ
ხოდა	xɔdɑ	χɔdɑ
ხომ	xɔm	χɔm
ხორბალი	xɔrbɑli	χɔrbɑlɪ
ხორვატია	xɔrvɑtʼiɑ	χɔrvɑtʼɪɑ
ხორთუმი	xɔrtʰumi	χɔrtʰumɪ
ხორუმი	xɔrumi	χɔrumɪ
ხორცი	xɔrtsi	χɔrtsɪ
ხორცსავსე	xɔrtssɑvsɛ	χɔrtssɑvsɛ
ხორცშესხმა	xɔrtsʃɛsxmɑ	χɔrtsʃɛsχmɑ
ხორხი	xɔrxi	χɔrχɪ
ხოტბა	xɔtʼbɑ	χɔtʼbɑ
ხოხობი	xɔxɔbi	χɔχɔbɪ
ხუთი	xutʰi	χutʰɪ
ხუთოცი	xutʰɔtsi	χutʰɔtsɪ
ხუთშაბათი	xutʰʃɑbɑtʰi	χutʰʃɑbɑtʰɪ
ხულიგანი	xuliɡɑni	χulɪɡɑnɪ
ხულიგნური	xuliɡnuri	χulɪɡnurɪ
ხუმრობა	xumrɔbɑ	χumrɔbɑ
ხუმრობს	xumrɔbs	χumrɔbs
ხურავს	xurɑvs	χurɑvs
ხურმა	xurmɑ	χurmɑ
ხუცური	xutsuri	χutsurɪ
ხშირი	xʃiri	χʃɪrɪ
ჯაბახანა	dʒɑbɑxɑnɑ	dʒɑbɑχɑnɑ
ჯაგარი	dʒɑɡɑri	dʒɑɡɑrɪ
ჯადოსნური	dʒɑdɔsnuri	dʒɑdɔsnurɪ
ჯადოქარი	dʒɑdɔkʰɑri	dʒɑdɔkʰɑrɪ
ჯავახეთი	dʒɑvɑxɛtʰi	dʒɑvɑχɛtʰɪ
ჯალათი	dʒɑlɑtʰi	dʒɑlɑtʰɪ
ჯალაღონია	dʒɑlɑɣɔniɑ	dʒɑlɑʁɔnɪɑ
ჯამაათი	dʒɑmɑɑtʰi	dʒɑmɑɑtʰɪ
ჯამაგირი	dʒɑmɑɡiri	dʒɑmɑɡɪrɪ
ჯანსაღად	dʒɑnsɑɣɑd	dʒɑnsɑʁɑd
ჯანსაღი	dʒɑnsɑɣi	dʒɑnsɑʁɪ
ჯართი	dʒɑrtʰi	dʒɑrtʰɪ
ჯარი	dʒɑri	dʒɑrɪ
ჯაშუში	dʒɑʃuʃi	dʒɑʃuʃɪ
ჯაჭვი	dʒɑtʃʼvi	dʒɑtʃʼvɪ
ჯგუფური	dʒɡupʰuri	dʒɡupʰurɪ
ჯეელი	dʒɛɛli	dʒɛɛlɪ
ჯეირანი	dʒɛirɑni	dʒɛɪrɑnɪ
ჯვარი	dʒvɑri	dʒvɑrɪ
ჯიბუტი	dʒibutʼi	dʒɪbutʼɪ
ჯიგარი	dʒiɡɑri	dʒɪɡɑrɪ
ჯილდო	dʒildɔ	dʒɪldɔ
ჯიხვი	dʒixvi	dʒɪχvɪ
ჯიჰადი	dʒihɑdi	dʒɪhɑdɪ
ჯოი	dʒɔi	dʒɔɪ
ჯონჯოლი	dʒɔndʒɔli	dʒɔndʒɔlɪ
ჯორი	dʒɔri	dʒɔrɪ
ჯოხი	dʒɔxi	dʒɔχɪ
ჯუნგლი	dʒunɡli	dʒunɡlɪ
ჰაერი	hɑɛri	hɑɛrɪ
ჰაიკუ	hɑikʼu	hɑɪkʼu
ჰაიტი	hɑitʼi	hɑɪtʼɪ
ჰაკერი	hɑkʼɛri	hɑkʼɛrɪ
ჰამაკი	hɑmɑkʼi	hɑmɑkʼɪ
ჰაფნიუმი	hɑpʰniumi	hɑpʰnɪumɪ
ჰაშიში	hɑʃiʃi	hɑʃɪʃɪ
ჰელიუმი	hɛliumi	hɛlɪumɪ
ჰერმეტული	hɛrmɛtʼuli	hɛrmɛtʼulɪ
ჰერცოგი	hɛrtsɔɡi	hɛrtsɔɡɪ
ჰეტეროგენული	hɛtʼɛrɔɡɛnuli	hɛtʼɛrɔɡɛnulɪ
ჰეტეროსექსუალი	hɛtʼɛrɔsɛkʰsuɑli	hɛtʼɛrɔsɛkʰsuɑlɪ
ჰიენა	hiɛnɑ	hɪɛnɑ
ჰიმნი	himni	hɪmnɪ
ჰიპერბოლური	hipʼɛrbɔluri	hɪpʼɛrbɔlurɪ
ჰოლმიუმი	hɔlmiumi	hɔlmɪumɪ
ჰომოსექსუალი	hɔmɔsɛkʰsuɑli	hɔmɔsɛkʰsuɑlɪ
ჰონდურასი	hɔndurɑsi	hɔndurɑsɪ
ჰქვია	hkʰviɑ	hkʰvɪɑ
